home,home_score,away,away_score,diff,home_win,id,year,week
PIT,13,TEN,10,3,1,2009091000,2009,1
ATL,19,MIA,7,12,1,2009091300,2009,1
BAL,38,KC,24,14,1,2009091301,2009,1
CAR,10,PHI,38,-28,0,2009091302,2009,1
CIN,7,DEN,12,-5,0,2009091303,2009,1
CLE,20,MIN,34,-14,0,2009091304,2009,1
HOU,7,NYJ,24,-17,0,2009091305,2009,1
IND,14,JAC,12,2,1,2009091306,2009,1
NO,45,DET,27,18,1,2009091307,2009,1
TB,21,DAL,34,-13,0,2009091308,2009,1
ARI,16,SF,20,-4,0,2009091309,2009,1
NYG,23,WAS,17,6,1,2009091310,2009,1
SEA,28,STL,0,28,1,2009091311,2009,1
GB,21,CHI,15,6,1,2009091312,2009,1
NE,25,BUF,24,1,1,2009091400,2009,1
OAK,20,SD,24,-4,0,2009091401,2009,1
ATL,28,CAR,20,8,1,2009092000,2009,2
DET,13,MIN,27,-14,0,2009092001,2009,2
GB,24,CIN,31,-7,0,2009092002,2009,2
JAC,17,ARI,31,-14,0,2009092003,2009,2
KC,10,OAK,13,-3,0,2009092004,2009,2
NYJ,16,NE,9,7,1,2009092005,2009,2
PHI,22,NO,48,-26,0,2009092006,2009,2
TEN,31,HOU,34,-3,0,2009092007,2009,2
WAS,9,STL,7,2,1,2009092008,2009,2
BUF,33,TB,20,13,1,2009092009,2009,2
SF,23,SEA,10,13,1,2009092010,2009,2
CHI,17,PIT,14,3,1,2009092011,2009,2
DEN,27,CLE,6,21,1,2009092012,2009,2
SD,26,BAL,31,-5,0,2009092013,2009,2
DAL,31,NYG,33,-2,0,2009092014,2009,2
MIA,23,IND,27,-4,0,2009092100,2009,2
BAL,34,CLE,3,31,1,2009092700,2009,3
CIN,23,PIT,20,3,1,2009092701,2009,3
DET,19,WAS,14,5,1,2009092702,2009,3
HOU,24,JAC,31,-7,0,2009092703,2009,3
MIN,27,SF,24,3,1,2009092704,2009,3
NE,26,ATL,10,16,1,2009092705,2009,3
PHI,34,KC,14,20,1,2009092706,2009,3
STL,17,GB,36,-19,0,2009092707,2009,3
TB,0,NYG,24,-24,0,2009092708,2009,3
BUF,7,NO,27,-20,0,2009092709,2009,3
SEA,19,CHI,25,-6,0,2009092710,2009,3
NYJ,24,TEN,17,7,1,2009092711,2009,3
OAK,3,DEN,23,-20,0,2009092712,2009,3
SD,23,MIA,13,10,1,2009092713,2009,3
ARI,10,IND,31,-21,0,2009092714,2009,3
DAL,21,CAR,7,14,1,2009092800,2009,3
CHI,48,DET,24,24,1,2009100400,2009,4
CLE,20,CIN,23,-3,0,2009100401,2009,4
HOU,29,OAK,6,23,1,2009100402,2009,4
IND,34,SEA,17,17,1,2009100403,2009,4
JAC,37,TEN,17,20,1,2009100404,2009,4
KC,16,NYG,27,-11,0,2009100405,2009,4
NE,27,BAL,21,6,1,2009100406,2009,4
WAS,16,TB,13,3,1,2009100407,2009,4
MIA,38,BUF,10,28,1,2009100408,2009,4
NO,24,NYJ,10,14,1,2009100409,2009,4
DEN,17,DAL,10,7,1,2009100410,2009,4
SF,35,STL,0,35,1,2009100411,2009,4
PIT,38,SD,28,10,1,2009100412,2009,4
MIN,30,GB,23,7,1,2009100500,2009,4
BAL,14,CIN,17,-3,0,2009101100,2009,5
BUF,3,CLE,6,-3,0,2009101101,2009,5
CAR,20,WAS,17,3,1,2009101102,2009,5
DET,20,PIT,28,-8,0,2009101103,2009,5
KC,20,DAL,26,-6,0,2009101104,2009,5
NYG,44,OAK,7,37,1,2009101105,2009,5
PHI,33,TB,14,19,1,2009101106,2009,5
STL,10,MIN,38,-28,0,2009101107,2009,5
SF,10,ATL,45,-35,0,2009101108,2009,5
ARI,28,HOU,21,7,1,2009101109,2009,5
DEN,20,NE,17,3,1,2009101110,2009,5
SEA,41,JAC,0,41,1,2009101111,2009,5
TEN,9,IND,31,-22,0,2009101112,2009,5
MIA,31,NYJ,27,4,1,2009101200,2009,5
CIN,17,HOU,28,-11,0,2009101800,2009,6
GB,26,DET,0,26,1,2009101801,2009,6
JAC,23,STL,20,3,1,2009101802,2009,6
MIN,33,BAL,31,2,1,2009101803,2009,6
NO,48,NYG,27,21,1,2009101804,2009,6
PIT,27,CLE,14,13,1,2009101805,2009,6
TB,21,CAR,28,-7,0,2009101806,2009,6
WAS,6,KC,14,-8,0,2009101807,2009,6
OAK,13,PHI,9,4,1,2009101808,2009,6
SEA,3,ARI,27,-24,0,2009101809,2009,6
NE,59,TEN,0,59,1,2009101810,2009,6
NYJ,13,BUF,16,-3,0,2009101811,2009,6
ATL,21,CHI,14,7,1,2009101812,2009,6
SD,23,DEN,34,-11,0,2009101900,2009,6
CIN,45,CHI,10,35,1,2009102500,2009,7
CLE,3,GB,31,-28,0,2009102501,2009,7
HOU,24,SF,21,3,1,2009102502,2009,7
KC,7,SD,37,-30,0,2009102503,2009,7
PIT,27,MIN,17,10,1,2009102504,2009,7
STL,6,IND,42,-36,0,2009102505,2009,7
TB,7,NE,35,-28,0,2009102506,2009,7
CAR,9,BUF,20,-11,0,2009102507,2009,7
OAK,0,NYJ,38,-38,0,2009102508,2009,7
DAL,37,ATL,21,16,1,2009102509,2009,7
MIA,34,NO,46,-12,0,2009102510,2009,7
NYG,17,ARI,24,-7,0,2009102511,2009,7
WAS,17,PHI,27,-10,0,2009102600,2009,7
BAL,30,DEN,7,23,1,2009110100,2009,8
BUF,10,HOU,31,-21,0,2009110101,2009,8
CHI,30,CLE,6,24,1,2009110102,2009,8
DAL,38,SEA,17,21,1,2009110103,2009,8
DET,10,STL,17,-7,0,2009110104,2009,8
GB,26,MIN,38,-12,0,2009110105,2009,8
IND,18,SF,14,4,1,2009110106,2009,8
NYJ,25,MIA,30,-5,0,2009110107,2009,8
SD,24,OAK,16,8,1,2009110108,2009,8
TEN,30,JAC,13,17,1,2009110109,2009,8
ARI,21,CAR,34,-13,0,2009110110,2009,8
PHI,40,NYG,17,23,1,2009110111,2009,8
NO,35,ATL,27,8,1,2009110200,2009,8
ATL,31,WAS,17,14,1,2009110800,2009,9
CHI,21,ARI,41,-20,0,2009110801,2009,9
CIN,17,BAL,7,10,1,2009110802,2009,9
IND,20,HOU,17,3,1,2009110803,2009,9
JAC,24,KC,21,3,1,2009110804,2009,9
NE,27,MIA,17,10,1,2009110805,2009,9
TB,38,GB,28,10,1,2009110806,2009,9
NO,30,CAR,20,10,1,2009110807,2009,9
SEA,32,DET,20,12,1,2009110808,2009,9
NYG,20,SD,21,-1,0,2009110809,2009,9
SF,27,TEN,34,-7,0,2009110810,2009,9
PHI,16,DAL,20,-4,0,2009110811,2009,9
DEN,10,PIT,28,-18,0,2009110900,2009,9
SF,10,CHI,6,4,1,2009111200,2009,10
CAR,28,ATL,19,9,1,2009111500,2009,10
MIA,25,TB,23,2,1,2009111501,2009,10
MIN,27,DET,10,17,1,2009111502,2009,10
NYJ,22,JAC,24,-2,0,2009111503,2009,10
PIT,12,CIN,18,-6,0,2009111504,2009,10
STL,23,NO,28,-5,0,2009111505,2009,10
TEN,41,BUF,17,24,1,2009111506,2009,10
WAS,27,DEN,17,10,1,2009111507,2009,10
OAK,10,KC,16,-6,0,2009111508,2009,10
ARI,31,SEA,20,11,1,2009111509,2009,10
GB,17,DAL,7,10,1,2009111510,2009,10
SD,31,PHI,23,8,1,2009111511,2009,10
IND,35,NE,34,1,1,2009111512,2009,10
CLE,0,BAL,16,-16,0,2009111600,2009,10
CAR,17,MIA,24,-7,0,2009111900,2009,11
BAL,15,IND,17,-2,0,2009112200,2009,11
DAL,7,WAS,6,1,1,2009112201,2009,11
DET,38,CLE,37,1,1,2009112202,2009,11
GB,30,SF,24,6,1,2009112203,2009,11
JAC,18,BUF,15,3,1,2009112204,2009,11
KC,27,PIT,24,3,1,2009112205,2009,11
MIN,35,SEA,9,26,1,2009112206,2009,11
NYG,34,ATL,31,3,1,2009112207,2009,11
TB,7,NO,38,-31,0,2009112208,2009,11
STL,13,ARI,21,-8,0,2009112209,2009,11
DEN,3,SD,32,-29,0,2009112210,2009,11
NE,31,NYJ,14,17,1,2009112211,2009,11
OAK,20,CIN,17,3,1,2009112212,2009,11
CHI,20,PHI,24,-4,0,2009112213,2009,11
HOU,17,TEN,20,-3,0,2009112300,2009,11
DET,12,GB,34,-22,0,2009112600,2009,12
DAL,24,OAK,7,17,1,2009112601,2009,12
DEN,26,NYG,6,20,1,2009112602,2009,12
ATL,20,TB,17,3,1,2009112900,2009,12
BUF,31,MIA,14,17,1,2009112901,2009,12
CIN,16,CLE,7,9,1,2009112902,2009,12
HOU,27,IND,35,-8,0,2009112903,2009,12
MIN,36,CHI,10,26,1,2009112904,2009,12
NYJ,17,CAR,6,11,1,2009112905,2009,12
PHI,27,WAS,24,3,1,2009112906,2009,12
STL,17,SEA,27,-10,0,2009112907,2009,12
TEN,20,ARI,17,3,1,2009112908,2009,12
SD,43,KC,14,29,1,2009112909,2009,12
SF,20,JAC,3,17,1,2009112910,2009,12
BAL,20,PIT,17,3,1,2009112911,2009,12
NO,38,NE,17,21,1,2009113000,2009,12
BUF,13,NYJ,19,-6,0,2009120300,2009,13
ATL,7,PHI,34,-27,0,2009120600,2009,13
CAR,16,TB,6,10,1,2009120601,2009,13
CHI,17,STL,9,8,1,2009120602,2009,13
CIN,23,DET,13,10,1,2009120603,2009,13
IND,27,TEN,17,10,1,2009120604,2009,13
JAC,23,HOU,18,5,1,2009120605,2009,13
KC,13,DEN,44,-31,0,2009120606,2009,13
PIT,24,OAK,27,-3,0,2009120607,2009,13
WAS,30,NO,33,-3,0,2009120608,2009,13
CLE,23,SD,30,-7,0,2009120609,2009,13
ARI,30,MIN,17,13,1,2009120610,2009,13
NYG,31,DAL,24,7,1,2009120611,2009,13
SEA,20,SF,17,3,1,2009120612,2009,13
MIA,22,NE,21,1,1,2009120613,2009,13
GB,27,BAL,14,13,1,2009120700,2009,13
CLE,13,PIT,6,7,1,2009121000,2009,14
ATL,23,NO,26,-3,0,2009121300,2009,14
BAL,48,DET,3,45,1,2009121301,2009,14
CHI,14,GB,21,-7,0,2009121302,2009,14
HOU,34,SEA,7,27,1,2009121303,2009,14
IND,28,DEN,16,12,1,2009121304,2009,14
JAC,10,MIA,14,-4,0,2009121305,2009,14
KC,10,BUF,16,-6,0,2009121306,2009,14
MIN,30,CIN,10,20,1,2009121307,2009,14
NE,20,CAR,10,10,1,2009121308,2009,14
TB,3,NYJ,26,-23,0,2009121309,2009,14
TEN,47,STL,7,40,1,2009121310,2009,14
OAK,13,WAS,34,-21,0,2009121311,2009,14
DAL,17,SD,20,-3,0,2009121312,2009,14
NYG,38,PHI,45,-7,0,2009121313,2009,14
SF,24,ARI,9,15,1,2009121400,2009,14
JAC,31,IND,35,-4,0,2009121700,2009,15
NO,17,DAL,24,-7,0,2009121900,2009,15
BAL,31,CHI,7,24,1,2009122000,2009,15
BUF,10,NE,17,-7,0,2009122001,2009,15
DET,24,ARI,31,-7,0,2009122002,2009,15
KC,34,CLE,41,-7,0,2009122003,2009,15
NYJ,7,ATL,10,-3,0,2009122004,2009,15
PHI,27,SF,13,14,1,2009122005,2009,15
PIT,37,GB,36,1,1,2009122006,2009,15
STL,13,HOU,16,-3,0,2009122007,2009,15
TEN,27,MIA,24,3,1,2009122008,2009,15
DEN,19,OAK,20,-1,0,2009122009,2009,15
SD,27,CIN,24,3,1,2009122010,2009,15
SEA,7,TB,24,-17,0,2009122011,2009,15
CAR,26,MIN,7,19,1,2009122012,2009,15
WAS,12,NYG,45,-33,0,2009122100,2009,15
TEN,17,SD,42,-25,0,2009122500,2009,16
ATL,31,BUF,3,28,1,2009122700,2009,16
CIN,17,KC,10,7,1,2009122701,2009,16
CLE,23,OAK,9,14,1,2009122702,2009,16
GB,48,SEA,10,38,1,2009122703,2009,16
MIA,20,HOU,27,-7,0,2009122704,2009,16
NYG,9,CAR,41,-32,0,2009122705,2009,16
NE,35,JAC,7,28,1,2009122706,2009,16
NO,17,TB,20,-3,0,2009122707,2009,16
PHI,30,DEN,27,3,1,2009122708,2009,16
PIT,23,BAL,20,3,1,2009122709,2009,16
ARI,31,STL,10,21,1,2009122710,2009,16
SF,20,DET,6,14,1,2009122711,2009,16
IND,15,NYJ,29,-14,0,2009122712,2009,16
WAS,0,DAL,17,-17,0,2009122713,2009,16
CHI,36,MIN,30,6,1,2009122800,2009,16
BUF,30,IND,7,23,1,2010010300,2009,17
CAR,23,NO,10,13,1,2010010301,2009,17
CLE,23,JAC,17,6,1,2010010302,2009,17
DAL,24,PHI,0,24,1,2010010303,2009,17
DET,23,CHI,37,-14,0,2010010304,2009,17
HOU,34,NE,27,7,1,2010010305,2009,17
MIA,24,PIT,30,-6,0,2010010306,2009,17
MIN,44,NYG,7,37,1,2010010307,2009,17
NYJ,37,CIN,0,37,1,2010010308,2009,17
STL,6,SF,28,-22,0,2010010309,2009,17
TB,10,ATL,20,-10,0,2010010310,2009,17
ARI,7,GB,33,-26,0,2010010311,2009,17
DEN,24,KC,44,-20,0,2010010312,2009,17
OAK,13,BAL,21,-8,0,2010010313,2009,17
SD,23,WAS,20,3,1,2010010314,2009,17
SEA,13,TEN,17,-4,0,2010010315,2009,17
NO,14,MIN,9,5,1,2010090900,2010,1
TB,17,CLE,14,3,1,2010091200,2010,1
BUF,10,MIA,15,-5,0,2010091201,2010,1
NE,38,CIN,24,14,1,2010091202,2010,1
HOU,34,IND,24,10,1,2010091203,2010,1
JAC,24,DEN,17,7,1,2010091204,2010,1
TEN,38,OAK,13,25,1,2010091205,2010,1
NYG,31,CAR,18,13,1,2010091206,2010,1
CHI,19,DET,14,5,1,2010091207,2010,1
STL,13,ARI,17,-4,0,2010091208,2010,1
PIT,15,ATL,9,6,1,2010091209,2010,1
PHI,20,GB,27,-7,0,2010091210,2010,1
SEA,31,SF,6,25,1,2010091211,2010,1
WAS,13,DAL,7,6,1,2010091212,2010,1
NYJ,9,BAL,10,-1,0,2010091300,2010,1
KC,21,SD,14,7,1,2010091301,2010,1
WAS,27,HOU,30,-3,0,2010091900,2010,2
GB,34,BUF,7,27,1,2010091901,2010,2
MIN,10,MIA,14,-4,0,2010091902,2010,2
CLE,14,KC,16,-2,0,2010091903,2010,2
TEN,11,PIT,19,-8,0,2010091904,2010,2
DAL,20,CHI,27,-7,0,2010091905,2010,2
DET,32,PHI,35,-3,0,2010091906,2010,2
ATL,41,ARI,7,34,1,2010091907,2010,2
CAR,7,TB,20,-13,0,2010091908,2010,2
DEN,31,SEA,14,17,1,2010091909,2010,2
OAK,16,STL,14,2,1,2010091910,2010,2
NYJ,28,NE,14,14,1,2010091911,2010,2
CIN,15,BAL,10,5,1,2010091912,2010,2
SD,38,JAC,13,25,1,2010091913,2010,2
IND,38,NYG,14,24,1,2010091914,2010,2
SF,22,NO,25,-3,0,2010092000,2010,2
NYG,10,TEN,29,-19,0,2010092600,2010,3
CAR,7,CIN,20,-13,0,2010092601,2010,3
TB,13,PIT,38,-25,0,2010092602,2010,3
NE,38,BUF,30,8,1,2010092603,2010,3
BAL,24,CLE,17,7,1,2010092604,2010,3
MIN,24,DET,10,14,1,2010092605,2010,3
NO,24,ATL,27,-3,0,2010092606,2010,3
STL,30,WAS,16,14,1,2010092607,2010,3
HOU,13,DAL,27,-14,0,2010092608,2010,3
KC,31,SF,10,21,1,2010092609,2010,3
JAC,3,PHI,28,-25,0,2010092610,2010,3
DEN,13,IND,27,-14,0,2010092611,2010,3
ARI,24,OAK,23,1,1,2010092612,2010,3
SEA,27,SD,20,7,1,2010092613,2010,3
MIA,23,NYJ,31,-8,0,2010092614,2010,3
CHI,20,GB,17,3,1,2010092700,2010,3
BUF,14,NYJ,38,-24,0,2010100300,2010,4
CLE,23,CIN,20,3,1,2010100301,2010,4
PIT,14,BAL,17,-3,0,2010100302,2010,4
TEN,20,DEN,26,-6,0,2010100303,2010,4
GB,28,DET,26,2,1,2010100304,2010,4
ATL,16,SF,14,2,1,2010100305,2010,4
NO,16,CAR,14,2,1,2010100306,2010,4
STL,20,SEA,3,17,1,2010100307,2010,4
JAC,31,IND,28,3,1,2010100308,2010,4
OAK,24,HOU,31,-7,0,2010100309,2010,4
PHI,12,WAS,17,-5,0,2010100310,2010,4
SD,41,ARI,10,31,1,2010100311,2010,4
NYG,17,CHI,3,14,1,2010100312,2010,4
MIA,14,NE,41,-27,0,2010100400,2010,4
BUF,26,JAC,36,-10,0,2010101000,2010,5
BAL,31,DEN,17,14,1,2010101001,2010,5
IND,19,KC,9,10,1,2010101002,2010,5
WAS,16,GB,13,3,1,2010101003,2010,5
DET,44,STL,6,38,1,2010101004,2010,5
CAR,6,CHI,23,-17,0,2010101005,2010,5
CIN,21,TB,24,-3,0,2010101006,2010,5
CLE,10,ATL,20,-10,0,2010101007,2010,5
HOU,10,NYG,34,-24,0,2010101008,2010,5
ARI,30,NO,20,10,1,2010101009,2010,5
DAL,27,TEN,34,-7,0,2010101010,2010,5
OAK,35,SD,27,8,1,2010101011,2010,5
SF,24,PHI,27,-3,0,2010101012,2010,5
NYJ,29,MIN,20,9,1,2010101100,2010,5
GB,20,MIA,23,-3,0,2010101700,2010,6
STL,20,SD,17,3,1,2010101701,2010,6
NE,23,BAL,20,3,1,2010101702,2010,6
PIT,28,CLE,10,18,1,2010101703,2010,6
HOU,35,KC,31,4,1,2010101704,2010,6
NYG,28,DET,20,8,1,2010101705,2010,6
PHI,31,ATL,17,14,1,2010101706,2010,6
CHI,20,SEA,23,-3,0,2010101707,2010,6
TB,6,NO,31,-25,0,2010101708,2010,6
DEN,20,NYJ,24,-4,0,2010101709,2010,6
SF,17,OAK,9,8,1,2010101710,2010,6
MIN,24,DAL,21,3,1,2010101711,2010,6
WAS,24,IND,27,-3,0,2010101712,2010,6
JAC,3,TEN,30,-27,0,2010101800,2010,6
ATL,39,CIN,32,7,1,2010102400,2010,7
MIA,22,PIT,23,-1,0,2010102401,2010,7
BAL,37,BUF,34,3,1,2010102402,2010,7
KC,42,JAC,20,22,1,2010102403,2010,7
NO,17,CLE,30,-13,0,2010102404,2010,7
CHI,14,WAS,17,-3,0,2010102405,2010,7
CAR,23,SF,20,3,1,2010102406,2010,7
TB,18,STL,17,1,1,2010102407,2010,7
TEN,37,PHI,19,18,1,2010102408,2010,7
SEA,22,ARI,10,12,1,2010102409,2010,7
SD,20,NE,23,-3,0,2010102410,2010,7
DEN,14,OAK,59,-45,0,2010102411,2010,7
GB,28,MIN,24,4,1,2010102412,2010,7
DAL,35,NYG,41,-6,0,2010102500,2010,7
SF,24,DEN,16,8,1,2010103100,2010,8
DAL,17,JAC,35,-18,0,2010103101,2010,8
CIN,14,MIA,22,-8,0,2010103102,2010,8
KC,13,BUF,10,3,1,2010103103,2010,8
DET,37,WAS,25,12,1,2010103104,2010,8
STL,20,CAR,10,10,1,2010103105,2010,8
NYJ,0,GB,9,-9,0,2010103106,2010,8
SD,33,TEN,25,8,1,2010103107,2010,8
NE,28,MIN,18,10,1,2010103108,2010,8
ARI,35,TB,38,-3,0,2010103109,2010,8
OAK,33,SEA,3,30,1,2010103110,2010,8
NO,20,PIT,10,10,1,2010103111,2010,8
IND,30,HOU,17,13,1,2010110100,2010,8
DET,20,NYJ,23,-3,0,2010110700,2010,9
BAL,26,MIA,10,16,1,2010110701,2010,9
CLE,34,NE,14,20,1,2010110702,2010,9
HOU,23,SD,29,-6,0,2010110703,2010,9
BUF,19,CHI,22,-3,0,2010110704,2010,9
MIN,27,ARI,24,3,1,2010110705,2010,9
ATL,27,TB,21,6,1,2010110706,2010,9
CAR,3,NO,34,-31,0,2010110707,2010,9
SEA,7,NYG,41,-34,0,2010110708,2010,9
PHI,26,IND,24,2,1,2010110709,2010,9
OAK,23,KC,20,3,1,2010110710,2010,9
GB,45,DAL,7,38,1,2010110711,2010,9
CIN,21,PIT,27,-6,0,2010110800,2010,9
ATL,26,BAL,21,5,1,2010111100,2010,10
MIA,29,TEN,17,12,1,2010111400,2010,10
CLE,20,NYJ,26,-6,0,2010111401,2010,10
IND,23,CIN,17,6,1,2010111402,2010,10
JAC,31,HOU,24,7,1,2010111403,2010,10
CHI,27,MIN,13,14,1,2010111404,2010,10
TB,31,CAR,16,15,1,2010111405,2010,10
BUF,14,DET,12,2,1,2010111406,2010,10
DEN,49,KC,29,20,1,2010111407,2010,10
NYG,20,DAL,33,-13,0,2010111408,2010,10
ARI,18,SEA,36,-18,0,2010111409,2010,10
SF,23,STL,20,3,1,2010111410,2010,10
PIT,26,NE,39,-13,0,2010111411,2010,10
WAS,28,PHI,59,-31,0,2010111500,2010,10
MIA,0,CHI,16,-16,0,2010111800,2010,11
CAR,13,BAL,37,-24,0,2010112100,2010,11
NYJ,30,HOU,27,3,1,2010112101,2010,11
CIN,31,BUF,49,-18,0,2010112102,2010,11
PIT,35,OAK,3,32,1,2010112103,2010,11
JAC,24,CLE,20,4,1,2010112104,2010,11
DAL,35,DET,19,16,1,2010112105,2010,11
MIN,3,GB,31,-28,0,2010112106,2010,11
NO,34,SEA,19,15,1,2010112107,2010,11
TEN,16,WAS,19,-3,0,2010112108,2010,11
KC,31,ARI,13,18,1,2010112109,2010,11
STL,17,ATL,34,-17,0,2010112110,2010,11
SF,0,TB,21,-21,0,2010112111,2010,11
NE,31,IND,28,3,1,2010112112,2010,11
PHI,27,NYG,17,10,1,2010112113,2010,11
SD,35,DEN,14,21,1,2010112200,2010,11
DET,24,NE,45,-21,0,2010112500,2010,12
DAL,27,NO,30,-3,0,2010112501,2010,12
NYJ,26,CIN,10,16,1,2010112502,2010,12
NYG,24,JAC,20,4,1,2010112800,2010,12
BUF,16,PIT,19,-3,0,2010112801,2010,12
HOU,20,TEN,0,20,1,2010112802,2010,12
WAS,13,MIN,17,-4,0,2010112803,2010,12
CHI,31,PHI,26,5,1,2010112804,2010,12
ATL,20,GB,17,3,1,2010112805,2010,12
BAL,17,TB,10,7,1,2010112806,2010,12
CLE,24,CAR,23,1,1,2010112807,2010,12
SEA,24,KC,42,-18,0,2010112808,2010,12
OAK,17,MIA,33,-16,0,2010112809,2010,12
DEN,33,STL,36,-3,0,2010112810,2010,12
IND,14,SD,36,-22,0,2010112811,2010,12
ARI,6,SF,27,-21,0,2010112900,2010,12
PHI,34,HOU,24,10,1,2010120200,2010,13
MIN,38,BUF,14,24,1,2010120500,2010,13
MIA,10,CLE,13,-3,0,2010120501,2010,13
TEN,6,JAC,17,-11,0,2010120502,2010,13
KC,10,DEN,6,4,1,2010120503,2010,13
NYG,31,WAS,7,24,1,2010120504,2010,13
DET,20,CHI,24,-4,0,2010120505,2010,13
GB,34,SF,16,18,1,2010120506,2010,13
TB,24,ATL,28,-4,0,2010120507,2010,13
CIN,30,NO,34,-4,0,2010120508,2010,13
SD,13,OAK,28,-15,0,2010120509,2010,13
IND,35,DAL,38,-3,0,2010120510,2010,13
ARI,6,STL,19,-13,0,2010120511,2010,13
SEA,31,CAR,14,17,1,2010120512,2010,13
BAL,10,PIT,13,-3,0,2010120513,2010,13
NE,45,NYJ,3,42,1,2010120600,2010,13
TEN,28,IND,30,-2,0,2010120900,2010,14
CHI,7,NE,36,-29,0,2010121200,2010,14
BUF,13,CLE,6,7,1,2010121201,2010,14
PIT,23,CIN,7,16,1,2010121202,2010,14
JAC,38,OAK,31,7,1,2010121203,2010,14
WAS,16,TB,17,-1,0,2010121204,2010,14
DET,7,GB,3,4,1,2010121205,2010,14
CAR,10,ATL,31,-21,0,2010121207,2010,14
NO,31,STL,13,18,1,2010121208,2010,14
SF,40,SEA,21,19,1,2010121209,2010,14
NYJ,6,MIA,10,-4,0,2010121210,2010,14
ARI,43,DEN,13,30,1,2010121211,2010,14
SD,31,KC,0,31,1,2010121212,2010,14
DAL,27,PHI,30,-3,0,2010121213,2010,14
HOU,28,BAL,34,-6,0,2010121300,2010,14
MIN,3,NYG,21,-18,0,2010121301,2010,14
SD,34,SF,7,27,1,2010121600,2010,15
STL,13,KC,27,-14,0,2010121900,2010,15
MIA,14,BUF,17,-3,0,2010121901,2010,15
CIN,19,CLE,17,2,1,2010121902,2010,15
IND,34,JAC,24,10,1,2010121903,2010,15
TEN,31,HOU,17,14,1,2010121904,2010,15
DAL,33,WAS,30,3,1,2010121905,2010,15
NYG,31,PHI,38,-7,0,2010121906,2010,15
CAR,19,ARI,12,7,1,2010121907,2010,15
TB,20,DET,23,-3,0,2010121908,2010,15
BAL,30,NO,24,6,1,2010121909,2010,15
SEA,18,ATL,34,-16,0,2010121910,2010,15
PIT,17,NYJ,22,-5,0,2010121911,2010,15
OAK,39,DEN,23,16,1,2010121912,2010,15
NE,31,GB,27,4,1,2010121913,2010,15
MIN,14,CHI,40,-26,0,2010122000,2010,15
PIT,27,CAR,3,24,1,2010122300,2010,16
ARI,27,DAL,26,1,1,2010122500,2010,16
CHI,38,NYJ,34,4,1,2010122600,2010,16
BUF,3,NE,34,-31,0,2010122601,2010,16
CLE,10,BAL,20,-10,0,2010122602,2010,16
KC,34,TEN,14,20,1,2010122603,2010,16
TB,38,SEA,15,23,1,2010122605,2010,16
STL,25,SF,17,8,1,2010122606,2010,16
MIA,27,DET,34,-7,0,2010122607,2010,16
JAC,17,WAS,20,-3,0,2010122608,2010,16
DEN,24,HOU,23,1,1,2010122609,2010,16
OAK,26,IND,31,-5,0,2010122610,2010,16
GB,45,NYG,17,28,1,2010122611,2010,16
CIN,34,SD,20,14,1,2010122612,2010,16
ATL,14,NO,17,-3,0,2010122700,2010,16
PHI,14,MIN,24,-10,0,2010122800,2010,16
NE,38,MIA,7,31,1,2011010200,2010,17
NYJ,38,BUF,7,31,1,2011010201,2010,17
BAL,13,CIN,7,6,1,2011010202,2010,17
CLE,9,PIT,41,-32,0,2011010203,2010,17
HOU,34,JAC,17,17,1,2011010204,2010,17
IND,23,TEN,20,3,1,2011010205,2010,17
KC,10,OAK,31,-21,0,2011010206,2010,17
PHI,13,DAL,14,-1,0,2011010207,2010,17
WAS,14,NYG,17,-3,0,2011010208,2010,17
DET,20,MIN,13,7,1,2011010209,2010,17
GB,10,CHI,3,7,1,2011010210,2010,17
ATL,31,CAR,10,21,1,2011010211,2010,17
NO,13,TB,23,-10,0,2011010212,2010,17
DEN,28,SD,33,-5,0,2011010213,2010,17
SF,38,ARI,7,31,1,2011010214,2010,17
SEA,16,STL,6,10,1,2011010215,2010,17
GB,42,NO,34,8,1,2011090800,2011,1
BAL,35,PIT,7,28,1,2011091100,2011,1
CLE,17,CIN,27,-10,0,2011091101,2011,1
HOU,34,IND,7,27,1,2011091102,2011,1
JAC,16,TEN,14,2,1,2011091103,2011,1
KC,7,BUF,41,-34,0,2011091104,2011,1
CHI,30,ATL,12,18,1,2011091105,2011,1
TB,20,DET,27,-7,0,2011091106,2011,1
STL,13,PHI,31,-18,0,2011091107,2011,1
WAS,28,NYG,14,14,1,2011091108,2011,1
ARI,28,CAR,21,7,1,2011091109,2011,1
SF,33,SEA,17,16,1,2011091110,2011,1
SD,24,MIN,17,7,1,2011091111,2011,1
NYJ,27,DAL,24,3,1,2011091112,2011,1
MIA,24,NE,38,-14,0,2011091200,2011,1
DEN,20,OAK,23,-3,0,2011091201,2011,1
DET,48,KC,3,45,1,2011091800,2011,2
BUF,38,OAK,35,3,1,2011091801,2011,2
TEN,26,BAL,13,13,1,2011091802,2011,2
NYJ,32,JAC,3,29,1,2011091803,2011,2
IND,19,CLE,27,-8,0,2011091804,2011,2
WAS,22,ARI,21,1,1,2011091805,2011,2
MIN,20,TB,24,-4,0,2011091806,2011,2
CAR,23,GB,30,-7,0,2011091807,2011,2
NO,30,CHI,13,17,1,2011091808,2011,2
PIT,24,SEA,0,24,1,2011091809,2011,2
SF,24,DAL,27,-3,0,2011091810,2011,2
NE,35,SD,21,14,1,2011091811,2011,2
DEN,24,CIN,22,2,1,2011091812,2011,2
MIA,13,HOU,23,-10,0,2011091813,2011,2
ATL,35,PHI,31,4,1,2011091814,2011,2
NYG,28,STL,16,12,1,2011091900,2011,2
CAR,16,JAC,10,6,1,2011092500,2011,3
NO,40,HOU,33,7,1,2011092501,2011,3
BUF,34,NE,31,3,1,2011092502,2011,3
CLE,17,MIA,16,1,1,2011092503,2011,3
TEN,17,DEN,14,3,1,2011092504,2011,3
PHI,16,NYG,29,-13,0,2011092505,2011,3
MIN,23,DET,26,-3,0,2011092506,2011,3
CIN,8,SF,13,-5,0,2011092507,2011,3
OAK,34,NYJ,24,10,1,2011092508,2011,3
SD,20,KC,17,3,1,2011092509,2011,3
STL,7,BAL,37,-30,0,2011092510,2011,3
CHI,17,GB,27,-10,0,2011092511,2011,3
SEA,13,ARI,10,3,1,2011092512,2011,3
TB,16,ATL,13,3,1,2011092513,2011,3
IND,20,PIT,23,-3,0,2011092514,2011,3
DAL,18,WAS,16,2,1,2011092600,2011,3
CIN,23,BUF,20,3,1,2011100200,2011,4
CLE,13,TEN,31,-18,0,2011100201,2011,4
HOU,17,PIT,10,7,1,2011100202,2011,4
DAL,30,DET,34,-4,0,2011100203,2011,4
PHI,23,SF,24,-1,0,2011100204,2011,4
CHI,34,CAR,29,5,1,2011100205,2011,4
STL,10,WAS,17,-7,0,2011100206,2011,4
JAC,10,NO,23,-13,0,2011100207,2011,4
KC,22,MIN,17,5,1,2011100208,2011,4
ARI,27,NYG,31,-4,0,2011100209,2011,4
SEA,28,ATL,30,-2,0,2011100210,2011,4
GB,49,DEN,23,26,1,2011100211,2011,4
OAK,19,NE,31,-12,0,2011100212,2011,4
SD,26,MIA,16,10,1,2011100213,2011,4
BAL,34,NYJ,17,17,1,2011100214,2011,4
TB,24,IND,17,7,1,2011100300,2011,4
PIT,38,TEN,17,21,1,2011100900,2011,5
HOU,20,OAK,25,-5,0,2011100901,2011,5
IND,24,KC,28,-4,0,2011100902,2011,5
JAC,20,CIN,30,-10,0,2011100903,2011,5
NYG,25,SEA,36,-11,0,2011100904,2011,5
MIN,34,ARI,10,24,1,2011100905,2011,5
CAR,27,NO,30,-3,0,2011100906,2011,5
BUF,31,PHI,24,7,1,2011100907,2011,5
SF,48,TB,3,45,1,2011100908,2011,5
NE,30,NYJ,21,9,1,2011100909,2011,5
DEN,24,SD,29,-5,0,2011100910,2011,5
ATL,14,GB,25,-11,0,2011100911,2011,5
DET,24,CHI,13,11,1,2011101000,2011,5
NYG,27,BUF,24,3,1,2011101600,2011,6
CIN,27,IND,17,10,1,2011101601,2011,6
PIT,17,JAC,13,4,1,2011101602,2011,6
WAS,13,PHI,20,-7,0,2011101603,2011,6
DET,19,SF,25,-6,0,2011101604,2011,6
GB,24,STL,3,21,1,2011101605,2011,6
ATL,31,CAR,17,14,1,2011101606,2011,6
OAK,24,CLE,17,7,1,2011101607,2011,6
BAL,29,HOU,14,15,1,2011101608,2011,6
TB,26,NO,20,6,1,2011101609,2011,6
NE,20,DAL,16,4,1,2011101610,2011,6
CHI,39,MIN,10,29,1,2011101611,2011,6
NYJ,24,MIA,6,18,1,2011101700,2011,6
MIA,15,DEN,18,-3,0,2011102300,2011,7
NYJ,27,SD,21,6,1,2011102301,2011,7
TEN,7,HOU,41,-34,0,2011102302,2011,7
DET,16,ATL,23,-7,0,2011102303,2011,7
CAR,33,WAS,20,13,1,2011102304,2011,7
TB,18,CHI,24,-6,0,2011102305,2011,7
CLE,6,SEA,3,3,1,2011102306,2011,7
ARI,20,PIT,32,-12,0,2011102307,2011,7
OAK,0,KC,28,-28,0,2011102308,2011,7
MIN,27,GB,33,-6,0,2011102309,2011,7
DAL,34,STL,7,27,1,2011102310,2011,7
NO,62,IND,7,55,1,2011102311,2011,7
JAC,12,BAL,7,5,1,2011102400,2011,7
NYG,20,MIA,17,3,1,2011103000,2011,8
HOU,24,JAC,14,10,1,2011103001,2011,8
TEN,27,IND,10,17,1,2011103002,2011,8
CAR,21,MIN,24,-3,0,2011103003,2011,8
STL,31,NO,21,10,1,2011103004,2011,8
BAL,30,ARI,27,3,1,2011103005,2011,8
DEN,10,DET,45,-35,0,2011103006,2011,8
BUF,23,WAS,0,23,1,2011103007,2011,8
PIT,25,NE,17,8,1,2011103008,2011,8
SF,20,CLE,10,10,1,2011103009,2011,8
SEA,12,CIN,34,-22,0,2011103010,2011,8
PHI,34,DAL,7,27,1,2011103011,2011,8
KC,23,SD,20,3,1,2011103100,2011,8
BUF,11,NYJ,27,-16,0,2011110600,2011,9
HOU,30,CLE,12,18,1,2011110601,2011,9
KC,3,MIA,31,-28,0,2011110602,2011,9
DAL,23,SEA,13,10,1,2011110603,2011,9
WAS,11,SF,19,-8,0,2011110604,2011,9
NO,27,TB,16,11,1,2011110605,2011,9
IND,7,ATL,31,-24,0,2011110606,2011,9
OAK,24,DEN,38,-14,0,2011110607,2011,9
TEN,17,CIN,24,-7,0,2011110608,2011,9
NE,20,NYG,24,-4,0,2011110609,2011,9
SD,38,GB,45,-7,0,2011110610,2011,9
ARI,19,STL,13,6,1,2011110611,2011,9
PIT,20,BAL,23,-3,0,2011110612,2011,9
PHI,24,CHI,30,-6,0,2011110700,2011,9
SD,17,OAK,24,-7,0,2011111000,2011,10
DAL,44,BUF,7,37,1,2011111300,2011,10
CAR,3,TEN,30,-27,0,2011111301,2011,10
TB,9,HOU,37,-28,0,2011111302,2011,10
CIN,17,PIT,24,-7,0,2011111303,2011,10
IND,3,JAC,17,-14,0,2011111304,2011,10
KC,10,DEN,17,-7,0,2011111305,2011,10
PHI,17,ARI,21,-4,0,2011111306,2011,10
CHI,37,DET,13,24,1,2011111307,2011,10
ATL,23,NO,26,-3,0,2011111308,2011,10
MIA,20,WAS,9,11,1,2011111309,2011,10
CLE,12,STL,13,-1,0,2011111310,2011,10
SEA,22,BAL,17,5,1,2011111311,2011,10
SF,27,NYG,20,7,1,2011111312,2011,10
NYJ,16,NE,37,-21,0,2011111313,2011,10
GB,45,MIN,7,38,1,2011111400,2011,10
DEN,17,NYJ,13,4,1,2011111700,2011,11
MIN,21,OAK,27,-6,0,2011112000,2011,11
ATL,23,TEN,17,6,1,2011112001,2011,11
MIA,35,BUF,8,27,1,2011112002,2011,11
CLE,14,JAC,10,4,1,2011112003,2011,11
BAL,31,CIN,24,7,1,2011112004,2011,11
WAS,24,DAL,27,-3,0,2011112005,2011,11
DET,49,CAR,35,14,1,2011112006,2011,11
GB,35,TB,26,9,1,2011112007,2011,11
SF,23,ARI,7,16,1,2011112008,2011,11
STL,7,SEA,24,-17,0,2011112009,2011,11
CHI,31,SD,20,11,1,2011112010,2011,11
NYG,10,PHI,17,-7,0,2011112011,2011,11
NE,34,KC,3,31,1,2011112100,2011,11
DET,15,GB,27,-12,0,2011112400,2011,12
DAL,20,MIA,19,1,1,2011112401,2011,12
BAL,16,SF,6,10,1,2011112402,2011,12
NYJ,28,BUF,24,4,1,2011112700,2011,12
CIN,23,CLE,20,3,1,2011112701,2011,12
JAC,13,HOU,20,-7,0,2011112702,2011,12
ATL,24,MIN,14,10,1,2011112703,2011,12
STL,20,ARI,23,-3,0,2011112704,2011,12
IND,19,CAR,27,-8,0,2011112705,2011,12
TEN,23,TB,17,6,1,2011112706,2011,12
SEA,17,WAS,23,-6,0,2011112707,2011,12
OAK,25,CHI,20,5,1,2011112708,2011,12
PHI,20,NE,38,-18,0,2011112709,2011,12
SD,13,DEN,16,-3,0,2011112710,2011,12
KC,9,PIT,13,-4,0,2011112711,2011,12
NO,49,NYG,24,25,1,2011112800,2011,12
SEA,31,PHI,14,17,1,2011120100,2011,13
WAS,19,NYJ,34,-15,0,2011120400,2011,13
CHI,3,KC,10,-7,0,2011120401,2011,13
BUF,17,TEN,23,-6,0,2011120402,2011,13
MIA,34,OAK,14,20,1,2011120403,2011,13
CLE,10,BAL,24,-14,0,2011120404,2011,13
PIT,35,CIN,7,28,1,2011120405,2011,13
NO,31,DET,17,14,1,2011120406,2011,13
TB,19,CAR,38,-19,0,2011120407,2011,13
HOU,17,ATL,10,7,1,2011120408,2011,13
MIN,32,DEN,35,-3,0,2011120409,2011,13
NYG,35,GB,38,-3,0,2011120410,2011,13
ARI,19,DAL,13,6,1,2011120411,2011,13
SF,26,STL,0,26,1,2011120412,2011,13
NE,31,IND,24,7,1,2011120413,2011,13
JAC,14,SD,38,-24,0,2011120500,2011,13
PIT,14,CLE,3,11,1,2011120800,2011,14
WAS,27,NE,34,-7,0,2011121100,2011,14
GB,46,OAK,16,30,1,2011121101,2011,14
NYJ,37,KC,10,27,1,2011121102,2011,14
CIN,19,HOU,20,-1,0,2011121103,2011,14
BAL,24,IND,10,14,1,2011121104,2011,14
DET,34,MIN,28,6,1,2011121105,2011,14
CAR,23,ATL,31,-8,0,2011121106,2011,14
MIA,10,PHI,26,-16,0,2011121107,2011,14
JAC,41,TB,14,27,1,2011121108,2011,14
TEN,17,NO,22,-5,0,2011121109,2011,14
ARI,21,SF,19,2,1,2011121110,2011,14
DEN,13,CHI,10,3,1,2011121111,2011,14
SD,37,BUF,10,27,1,2011121112,2011,14
DAL,34,NYG,37,-3,0,2011121113,2011,14
SEA,30,STL,13,17,1,2011121200,2011,14
ATL,41,JAC,14,27,1,2011121500,2011,15
TB,15,DAL,31,-16,0,2011121700,2011,15
STL,13,CIN,20,-7,0,2011121800,2011,15
BUF,23,MIA,30,-7,0,2011121801,2011,15
IND,27,TEN,13,14,1,2011121802,2011,15
NYG,10,WAS,23,-13,0,2011121803,2011,15
CHI,14,SEA,38,-24,0,2011121804,2011,15
MIN,20,NO,42,-22,0,2011121805,2011,15
HOU,13,CAR,28,-15,0,2011121806,2011,15
KC,19,GB,14,5,1,2011121807,2011,15
OAK,27,DET,28,-1,0,2011121808,2011,15
PHI,45,NYJ,19,26,1,2011121809,2011,15
ARI,20,CLE,17,3,1,2011121810,2011,15
DEN,23,NE,41,-18,0,2011121811,2011,15
SD,34,BAL,14,20,1,2011121812,2011,15
SF,20,PIT,3,17,1,2011121900,2011,15
IND,19,HOU,16,3,1,2011122200,2011,16
BUF,40,DEN,14,26,1,2011122400,2011,16
NE,27,MIA,24,3,1,2011122401,2011,16
BAL,20,CLE,14,6,1,2011122402,2011,16
TEN,23,JAC,17,6,1,2011122403,2011,16
KC,13,OAK,16,-3,0,2011122404,2011,16
NYJ,14,NYG,29,-15,0,2011122405,2011,16
WAS,26,MIN,33,-7,0,2011122406,2011,16
CAR,48,TB,16,32,1,2011122407,2011,16
CIN,23,ARI,16,7,1,2011122408,2011,16
PIT,27,STL,0,27,1,2011122409,2011,16
DET,38,SD,10,28,1,2011122410,2011,16
DAL,7,PHI,20,-13,0,2011122411,2011,16
SEA,17,SF,19,-2,0,2011122412,2011,16
GB,35,CHI,21,14,1,2011122500,2011,16
NO,45,ATL,16,29,1,2011122600,2011,16
MIA,19,NYJ,17,2,1,2012010100,2011,17
NE,49,BUF,21,28,1,2012010101,2011,17
CIN,16,BAL,24,-8,0,2012010102,2011,17
CLE,9,PIT,13,-4,0,2012010103,2011,17
HOU,22,TEN,23,-1,0,2012010104,2011,17
JAC,19,IND,13,6,1,2012010105,2011,17
NYG,31,DAL,14,17,1,2012010106,2011,17
PHI,34,WAS,10,24,1,2012010107,2011,17
GB,45,DET,41,4,1,2012010108,2011,17
MIN,13,CHI,17,-4,0,2012010109,2011,17
ATL,45,TB,24,21,1,2012010110,2011,17
NO,45,CAR,17,28,1,2012010111,2011,17
STL,27,SF,34,-7,0,2012010112,2011,17
DEN,3,KC,7,-4,0,2012010113,2011,17
OAK,26,SD,38,-12,0,2012010114,2011,17
ARI,23,SEA,20,3,1,2012010115,2011,17
NYG,17,DAL,24,-7,0,2012090500,2012,1
CHI,41,IND,21,20,1,2012090900,2012,1
MIN,26,JAC,23,3,1,2012090901,2012,1
NYJ,48,BUF,28,20,1,2012090902,2012,1
HOU,30,MIA,10,20,1,2012090903,2012,1
TEN,13,NE,34,-21,0,2012090904,2012,1
DET,27,STL,23,4,1,2012090905,2012,1
NO,32,WAS,40,-8,0,2012090906,2012,1
CLE,16,PHI,17,-1,0,2012090907,2012,1
KC,24,ATL,40,-16,0,2012090908,2012,1
GB,22,SF,30,-8,0,2012090909,2012,1
ARI,20,SEA,16,4,1,2012090910,2012,1
TB,16,CAR,10,6,1,2012090911,2012,1
DEN,31,PIT,19,12,1,2012090912,2012,1
BAL,44,CIN,13,31,1,2012091000,2012,1
OAK,14,SD,22,-8,0,2012091001,2012,1
GB,23,CHI,10,13,1,2012091300,2012,2
NYG,41,TB,34,7,1,2012091600,2012,2
CAR,35,NO,27,8,1,2012091601,2012,2
NE,18,ARI,20,-2,0,2012091602,2012,2
IND,23,MIN,20,3,1,2012091603,2012,2
PHI,24,BAL,23,1,1,2012091604,2012,2
BUF,35,KC,17,18,1,2012091605,2012,2
CIN,34,CLE,27,7,1,2012091606,2012,2
JAC,7,HOU,27,-20,0,2012091607,2012,2
SEA,27,DAL,7,20,1,2012091608,2012,2
STL,31,WAS,28,3,1,2012091609,2012,2
PIT,27,NYJ,10,17,1,2012091610,2012,2
SD,38,TEN,10,28,1,2012091611,2012,2
MIA,35,OAK,13,22,1,2012091612,2012,2
SF,27,DET,19,8,1,2012091613,2012,2
ATL,27,DEN,21,6,1,2012091700,2012,2
CAR,7,NYG,36,-29,0,2012092000,2012,3
DAL,16,TB,10,6,1,2012092300,2012,3
CHI,23,STL,6,17,1,2012092301,2012,3
MIN,24,SF,13,11,1,2012092302,2012,3
TEN,44,DET,41,3,1,2012092303,2012,3
WAS,31,CIN,38,-7,0,2012092304,2012,3
NO,24,KC,27,-3,0,2012092305,2012,3
MIA,20,NYJ,23,-3,0,2012092306,2012,3
CLE,14,BUF,24,-10,0,2012092307,2012,3
IND,17,JAC,22,-5,0,2012092308,2012,3
ARI,27,PHI,6,21,1,2012092309,2012,3
SD,3,ATL,27,-24,0,2012092310,2012,3
DEN,25,HOU,31,-6,0,2012092311,2012,3
OAK,34,PIT,31,3,1,2012092312,2012,3
BAL,31,NE,30,1,1,2012092313,2012,3
SEA,14,GB,12,2,1,2012092400,2012,3
BAL,23,CLE,16,7,1,2012092700,2012,4
BUF,28,NE,52,-24,0,2012093000,2012,4
HOU,38,TEN,14,24,1,2012093001,2012,4
KC,20,SD,37,-17,0,2012093002,2012,4
DET,13,MIN,20,-7,0,2012093003,2012,4
ATL,30,CAR,28,2,1,2012093004,2012,4
STL,19,SEA,13,6,1,2012093005,2012,4
NYJ,0,SF,34,-34,0,2012093006,2012,4
ARI,24,MIA,21,3,1,2012093007,2012,4
DEN,37,OAK,6,31,1,2012093008,2012,4
JAC,10,CIN,27,-17,0,2012093009,2012,4
GB,28,NO,27,1,1,2012093010,2012,4
TB,22,WAS,24,-2,0,2012093011,2012,4
PHI,19,NYG,17,2,1,2012093012,2012,4
DAL,18,CHI,34,-16,0,2012100100,2012,4
STL,17,ARI,3,14,1,2012100400,2012,5
WAS,17,ATL,24,-7,0,2012100700,2012,5
PIT,16,PHI,14,2,1,2012100701,2012,5
IND,30,GB,27,3,1,2012100702,2012,5
NYG,41,CLE,27,14,1,2012100703,2012,5
MIN,30,TEN,7,23,1,2012100704,2012,5
CIN,13,MIA,17,-4,0,2012100705,2012,5
KC,6,BAL,9,-3,0,2012100706,2012,5
CAR,12,SEA,16,-4,0,2012100707,2012,5
JAC,3,CHI,41,-38,0,2012100708,2012,5
NE,31,DEN,21,10,1,2012100709,2012,5
SF,45,BUF,3,42,1,2012100710,2012,5
NO,31,SD,24,7,1,2012100711,2012,5
NYJ,17,HOU,23,-6,0,2012100800,2012,5
TEN,26,PIT,23,3,1,2012101100,2012,6
ATL,23,OAK,20,3,1,2012101400,2012,6
TB,38,KC,10,28,1,2012101401,2012,6
NYJ,35,IND,9,26,1,2012101402,2012,6
CLE,34,CIN,24,10,1,2012101403,2012,6
PHI,23,DET,26,-3,0,2012101404,2012,6
MIA,17,STL,14,3,1,2012101405,2012,6
BAL,31,DAL,29,2,1,2012101406,2012,6
ARI,16,BUF,19,-3,0,2012101407,2012,6
SEA,24,NE,23,1,1,2012101408,2012,6
SF,3,NYG,26,-23,0,2012101409,2012,6
WAS,38,MIN,26,12,1,2012101410,2012,6
HOU,24,GB,42,-18,0,2012101411,2012,6
SD,24,DEN,35,-11,0,2012101500,2012,6
SF,13,SEA,6,7,1,2012101800,2012,7
NYG,27,WAS,23,4,1,2012102100,2012,7
MIN,21,ARI,14,7,1,2012102101,2012,7
CAR,14,DAL,19,-5,0,2012102102,2012,7
TB,28,NO,35,-7,0,2012102103,2012,7
STL,20,GB,30,-10,0,2012102104,2012,7
HOU,43,BAL,13,30,1,2012102105,2012,7
IND,17,CLE,13,4,1,2012102106,2012,7
BUF,34,TEN,35,-1,0,2012102107,2012,7
NE,29,NYJ,26,3,1,2012102108,2012,7
OAK,26,JAC,23,3,1,2012102109,2012,7
CIN,17,PIT,24,-7,0,2012102110,2012,7
CHI,13,DET,7,6,1,2012102200,2012,7
MIN,17,TB,36,-19,0,2012102500,2012,8
GB,24,JAC,15,9,1,2012102800,2012,8
NYJ,9,MIA,30,-21,0,2012102801,2012,8
CLE,7,SD,6,1,1,2012102802,2012,8
TEN,13,IND,19,-6,0,2012102803,2012,8
STL,7,NE,45,-38,0,2012102804,2012,8
PHI,17,ATL,30,-13,0,2012102805,2012,8
CHI,23,CAR,22,1,1,2012102806,2012,8
DET,28,SEA,24,4,1,2012102807,2012,8
PIT,27,WAS,12,15,1,2012102808,2012,8
KC,16,OAK,26,-10,0,2012102809,2012,8
DAL,24,NYG,29,-5,0,2012102810,2012,8
DEN,34,NO,14,20,1,2012102811,2012,8
ARI,3,SF,24,-21,0,2012102900,2012,8
SD,31,KC,13,18,1,2012110100,2012,9
WAS,13,CAR,21,-8,0,2012110400,2012,9
GB,31,ARI,17,14,1,2012110401,2012,9
JAC,14,DET,31,-17,0,2012110402,2012,9
TEN,20,CHI,51,-31,0,2012110403,2012,9
CIN,23,DEN,31,-8,0,2012110404,2012,9
CLE,15,BAL,25,-10,0,2012110405,2012,9
HOU,21,BUF,9,12,1,2012110406,2012,9
IND,23,MIA,20,3,1,2012110407,2012,9
SEA,30,MIN,20,10,1,2012110408,2012,9
OAK,32,TB,42,-10,0,2012110409,2012,9
NYG,20,PIT,24,-4,0,2012110410,2012,9
ATL,19,DAL,13,6,1,2012110411,2012,9
NO,28,PHI,13,15,1,2012110500,2012,9
JAC,10,IND,27,-17,0,2012110800,2012,10
CAR,14,DEN,36,-22,0,2012111100,2012,10
TB,34,SD,24,10,1,2012111101,2012,10
MIA,3,TEN,37,-34,0,2012111102,2012,10
NE,37,BUF,31,6,1,2012111103,2012,10
BAL,55,OAK,20,35,1,2012111104,2012,10
CIN,31,NYG,13,18,1,2012111105,2012,10
NO,31,ATL,27,4,1,2012111106,2012,10
MIN,34,DET,24,10,1,2012111107,2012,10
SEA,28,NYJ,7,21,1,2012111108,2012,10
PHI,23,DAL,38,-15,0,2012111109,2012,10
SF,24,STL,24,0,0,2012111110,2012,10
CHI,6,HOU,13,-7,0,2012111111,2012,10
PIT,16,KC,13,3,1,2012111200,2012,10
BUF,19,MIA,14,5,1,2012111500,2012,11
WAS,31,PHI,6,25,1,2012111800,2012,11
DET,20,GB,24,-4,0,2012111801,2012,11
ATL,23,ARI,19,4,1,2012111802,2012,11
CAR,21,TB,27,-6,0,2012111803,2012,11
DAL,23,CLE,20,3,1,2012111804,2012,11
STL,13,NYJ,27,-14,0,2012111805,2012,11
NE,59,IND,24,35,1,2012111806,2012,11
HOU,43,JAC,37,6,1,2012111807,2012,11
KC,6,CIN,28,-22,0,2012111808,2012,11
OAK,17,NO,38,-21,0,2012111809,2012,11
DEN,30,SD,23,7,1,2012111810,2012,11
PIT,10,BAL,13,-3,0,2012111811,2012,11
SF,32,CHI,7,25,1,2012111900,2012,11
DET,31,HOU,34,-3,0,2012112200,2012,12
DAL,31,WAS,38,-7,0,2012112201,2012,12
NYJ,19,NE,49,-30,0,2012112202,2012,12
CIN,34,OAK,10,24,1,2012112500,2012,12
CLE,20,PIT,14,6,1,2012112501,2012,12
IND,20,BUF,13,7,1,2012112502,2012,12
JAC,24,TEN,19,5,1,2012112503,2012,12
KC,9,DEN,17,-8,0,2012112504,2012,12
CHI,28,MIN,10,18,1,2012112505,2012,12
TB,23,ATL,24,-1,0,2012112506,2012,12
MIA,24,SEA,21,3,1,2012112507,2012,12
SD,13,BAL,16,-3,0,2012112508,2012,12
NO,21,SF,31,-10,0,2012112509,2012,12
ARI,17,STL,31,-14,0,2012112510,2012,12
NYG,38,GB,10,28,1,2012112511,2012,12
PHI,22,CAR,30,-8,0,2012112600,2012,12
ATL,23,NO,13,10,1,2012112900,2012,13
CHI,17,SEA,23,-6,0,2012120200,2012,13
GB,23,MIN,14,9,1,2012120201,2012,13
STL,16,SF,13,3,1,2012120202,2012,13
NYJ,7,ARI,6,1,1,2012120203,2012,13
KC,27,CAR,21,6,1,2012120204,2012,13
DET,33,IND,35,-2,0,2012120205,2012,13
BUF,34,JAC,18,16,1,2012120206,2012,13
MIA,16,NE,23,-7,0,2012120207,2012,13
TEN,10,HOU,24,-14,0,2012120208,2012,13
DEN,31,TB,23,8,1,2012120209,2012,13
BAL,20,PIT,23,-3,0,2012120210,2012,13
OAK,17,CLE,20,-3,0,2012120211,2012,13
SD,13,CIN,20,-7,0,2012120212,2012,13
DAL,38,PHI,33,5,1,2012120213,2012,13
WAS,17,NYG,16,1,1,2012120300,2012,13
OAK,13,DEN,26,-13,0,2012120600,2012,14
WAS,31,BAL,28,3,1,2012120900,2012,14
CLE,30,KC,7,23,1,2012120901,2012,14
PIT,24,SD,34,-10,0,2012120902,2012,14
IND,27,TEN,23,4,1,2012120903,2012,14
JAC,10,NYJ,17,-7,0,2012120904,2012,14
MIN,21,CHI,14,7,1,2012120905,2012,14
CAR,30,ATL,20,10,1,2012120906,2012,14
TB,21,PHI,23,-2,0,2012120907,2012,14
BUF,12,STL,15,-3,0,2012120908,2012,14
CIN,19,DAL,20,-1,0,2012120909,2012,14
SF,27,MIA,13,14,1,2012120910,2012,14
NYG,52,NO,27,25,1,2012120911,2012,14
SEA,58,ARI,0,58,1,2012120912,2012,14
GB,27,DET,20,7,1,2012120913,2012,14
NE,42,HOU,14,28,1,2012121000,2012,14
PHI,13,CIN,34,-21,0,2012121300,2012,15
CHI,13,GB,21,-8,0,2012121600,2012,15
ATL,34,NYG,0,34,1,2012121601,2012,15
NO,41,TB,0,41,1,2012121602,2012,15
STL,22,MIN,36,-14,0,2012121603,2012,15
CLE,21,WAS,38,-17,0,2012121604,2012,15
MIA,24,JAC,3,21,1,2012121605,2012,15
BAL,17,DEN,34,-17,0,2012121606,2012,15
HOU,29,IND,17,12,1,2012121607,2012,15
ARI,38,DET,10,28,1,2012121608,2012,15
SD,7,CAR,31,-24,0,2012121609,2012,15
BUF,17,SEA,50,-33,0,2012121610,2012,15
DAL,27,PIT,24,3,1,2012121611,2012,15
OAK,15,KC,0,15,1,2012121612,2012,15
NE,34,SF,41,-7,0,2012121613,2012,15
TEN,14,NYJ,10,4,1,2012121700,2012,15
DET,18,ATL,31,-13,0,2012122200,2012,16
GB,55,TEN,7,48,1,2012122300,2012,16
CAR,17,OAK,6,11,1,2012122301,2012,16
MIA,24,BUF,10,14,1,2012122302,2012,16
PIT,10,CIN,13,-3,0,2012122303,2012,16
JAC,16,NE,23,-7,0,2012122304,2012,16
KC,13,IND,20,-7,0,2012122305,2012,16
DAL,31,NO,34,-3,0,2012122306,2012,16
PHI,20,WAS,27,-7,0,2012122307,2012,16
TB,13,STL,28,-15,0,2012122308,2012,16
BAL,33,NYG,14,19,1,2012122309,2012,16
HOU,6,MIN,23,-17,0,2012122310,2012,16
DEN,34,CLE,12,22,1,2012122311,2012,16
ARI,13,CHI,28,-15,0,2012122312,2012,16
SEA,42,SF,13,29,1,2012122313,2012,16
NYJ,17,SD,27,-10,0,2012122314,2012,16
BUF,28,NYJ,9,19,1,2012123000,2012,17
NE,28,MIA,0,28,1,2012123001,2012,17
CIN,23,BAL,17,6,1,2012123002,2012,17
PIT,24,CLE,10,14,1,2012123003,2012,17
IND,28,HOU,16,12,1,2012123004,2012,17
TEN,38,JAC,20,18,1,2012123005,2012,17
NYG,42,PHI,7,35,1,2012123006,2012,17
WAS,28,DAL,18,10,1,2012123007,2012,17
DET,24,CHI,26,-2,0,2012123008,2012,17
MIN,37,GB,34,3,1,2012123009,2012,17
ATL,17,TB,22,-5,0,2012123010,2012,17
NO,38,CAR,44,-6,0,2012123011,2012,17
DEN,38,KC,3,35,1,2012123012,2012,17
SD,24,OAK,21,3,1,2012123013,2012,17
SF,27,ARI,13,14,1,2012123014,2012,17
SEA,20,STL,13,7,1,2012123015,2012,17
DEN,49,BAL,27,22,1,2013090500,2013,1
BUF,21,NE,23,-2,0,2013090800,2013,1
CAR,7,SEA,12,-5,0,2013090801,2013,1
CHI,24,CIN,21,3,1,2013090802,2013,1
CLE,10,MIA,23,-13,0,2013090803,2013,1
DET,34,MIN,24,10,1,2013090804,2013,1
IND,21,OAK,17,4,1,2013090805,2013,1
JAC,2,KC,28,-26,0,2013090806,2013,1
NYJ,18,TB,17,1,1,2013090807,2013,1
NO,23,ATL,17,6,1,2013090808,2013,1
PIT,9,TEN,16,-7,0,2013090809,2013,1
STL,27,ARI,24,3,1,2013090810,2013,1
SF,34,GB,28,6,1,2013090811,2013,1
DAL,36,NYG,31,5,1,2013090812,2013,1
WAS,27,PHI,33,-6,0,2013090900,2013,1
SD,28,HOU,31,-3,0,2013090901,2013,1
NE,13,NYJ,10,3,1,2013091200,2013,2
ATL,31,STL,24,7,1,2013091500,2013,2
BAL,14,CLE,6,8,1,2013091501,2013,2
BUF,24,CAR,23,1,1,2013091502,2013,2
CHI,31,MIN,30,1,1,2013091503,2013,2
GB,38,WAS,20,18,1,2013091504,2013,2
HOU,30,TEN,24,6,1,2013091505,2013,2
IND,20,MIA,24,-4,0,2013091506,2013,2
KC,17,DAL,16,1,1,2013091507,2013,2
PHI,30,SD,33,-3,0,2013091508,2013,2
ARI,25,DET,21,4,1,2013091509,2013,2
TB,14,NO,16,-2,0,2013091510,2013,2
NYG,23,DEN,41,-18,0,2013091511,2013,2
OAK,19,JAC,9,10,1,2013091512,2013,2
SEA,29,SF,3,26,1,2013091513,2013,2
CIN,20,PIT,10,10,1,2013091600,2013,2
PHI,16,KC,26,-10,0,2013091900,2013,3
BAL,30,HOU,9,21,1,2013092200,2013,3
CIN,34,GB,30,4,1,2013092201,2013,3
DAL,31,STL,7,24,1,2013092202,2013,3
MIA,27,ATL,23,4,1,2013092203,2013,3
MIN,27,CLE,31,-4,0,2013092204,2013,3
NYJ,27,BUF,20,7,1,2013092205,2013,3
NE,23,TB,3,20,1,2013092206,2013,3
NO,31,ARI,7,24,1,2013092207,2013,3
TEN,20,SD,17,3,1,2013092208,2013,3
WAS,20,DET,27,-7,0,2013092209,2013,3
CAR,38,NYG,0,38,1,2013092210,2013,3
SF,7,IND,27,-20,0,2013092211,2013,3
SEA,45,JAC,17,28,1,2013092212,2013,3
PIT,23,CHI,40,-17,0,2013092213,2013,3
DEN,37,OAK,21,16,1,2013092300,2013,3
STL,11,SF,35,-24,0,2013092600,2013,4
BUF,23,BAL,20,3,1,2013092900,2013,4
CLE,17,CIN,6,11,1,2013092901,2013,4
DET,40,CHI,32,8,1,2013092902,2013,4
HOU,20,SEA,23,-3,0,2013092903,2013,4
JAC,3,IND,37,-34,0,2013092904,2013,4
KC,31,NYG,7,24,1,2013092905,2013,4
MIN,34,PIT,27,7,1,2013092906,2013,4
TB,10,ARI,13,-3,0,2013092907,2013,4
TEN,38,NYJ,13,25,1,2013092908,2013,4
DEN,52,PHI,20,32,1,2013092909,2013,4
OAK,14,WAS,24,-10,0,2013092910,2013,4
SD,30,DAL,21,9,1,2013092911,2013,4
ATL,23,NE,30,-7,0,2013092912,2013,4
NO,38,MIA,17,21,1,2013093000,2013,4
CLE,37,BUF,24,13,1,2013100300,2013,5
CHI,18,NO,26,-8,0,2013100600,2013,5
CIN,13,NE,6,7,1,2013100601,2013,5
GB,22,DET,9,13,1,2013100602,2013,5
IND,34,SEA,28,6,1,2013100603,2013,5
MIA,23,BAL,26,-3,0,2013100604,2013,5
NYG,21,PHI,36,-15,0,2013100605,2013,5
STL,34,JAC,20,14,1,2013100606,2013,5
TEN,17,KC,26,-9,0,2013100607,2013,5
ARI,22,CAR,6,16,1,2013100608,2013,5
DAL,48,DEN,51,-3,0,2013100609,2013,5
OAK,27,SD,17,10,1,2013100610,2013,5
SF,34,HOU,3,31,1,2013100611,2013,5
ATL,28,NYJ,30,-2,0,2013100700,2013,5
CHI,27,NYG,21,6,1,2013101000,2013,6
BAL,17,GB,19,-2,0,2013101300,2013,6
BUF,24,CIN,27,-3,0,2013101301,2013,6
CLE,17,DET,31,-14,0,2013101302,2013,6
HOU,13,STL,38,-25,0,2013101303,2013,6
KC,24,OAK,7,17,1,2013101304,2013,6
MIN,10,CAR,35,-25,0,2013101305,2013,6
NYJ,6,PIT,19,-13,0,2013101306,2013,6
TB,20,PHI,31,-11,0,2013101307,2013,6
DEN,35,JAC,19,16,1,2013101308,2013,6
SEA,20,TEN,13,7,1,2013101309,2013,6
NE,30,NO,27,3,1,2013101310,2013,6
SF,32,ARI,20,12,1,2013101311,2013,6
DAL,31,WAS,16,15,1,2013101312,2013,6
SD,19,IND,9,10,1,2013101400,2013,6
ARI,22,SEA,34,-12,0,2013101700,2013,7
ATL,31,TB,23,8,1,2013102000,2013,7
CAR,30,STL,15,15,1,2013102001,2013,7
DET,24,CIN,27,-3,0,2013102002,2013,7
GB,31,CLE,13,18,1,2013102003,2013,7
JAC,6,SD,24,-18,0,2013102004,2013,7
KC,17,HOU,16,1,1,2013102005,2013,7
MIA,21,BUF,23,-2,0,2013102006,2013,7
NYJ,30,NE,27,3,1,2013102007,2013,7
PHI,3,DAL,17,-14,0,2013102008,2013,7
WAS,45,CHI,41,4,1,2013102009,2013,7
TEN,17,SF,31,-14,0,2013102010,2013,7
PIT,19,BAL,16,3,1,2013102011,2013,7
IND,39,DEN,33,6,1,2013102012,2013,7
NYG,23,MIN,7,16,1,2013102100,2013,7
TB,13,CAR,31,-18,0,2013102400,2013,8
DET,31,DAL,30,1,1,2013102700,2013,8
JAC,10,SF,42,-32,0,2013102701,2013,8
KC,23,CLE,17,6,1,2013102702,2013,8
NE,27,MIA,17,10,1,2013102703,2013,8
NO,35,BUF,17,18,1,2013102704,2013,8
PHI,7,NYG,15,-8,0,2013102705,2013,8
OAK,21,PIT,18,3,1,2013102706,2013,8
CIN,49,NYJ,9,40,1,2013102707,2013,8
ARI,27,ATL,13,14,1,2013102708,2013,8
DEN,45,WAS,21,24,1,2013102709,2013,8
MIN,31,GB,44,-13,0,2013102710,2013,8
STL,9,SEA,14,-5,0,2013102800,2013,8
MIA,22,CIN,20,2,1,2013103100,2013,9
BUF,13,KC,23,-10,0,2013110300,2013,9
CAR,34,ATL,10,24,1,2013110301,2013,9
DAL,27,MIN,23,4,1,2013110302,2013,9
NYJ,26,NO,20,6,1,2013110303,2013,9
STL,21,TEN,28,-7,0,2013110304,2013,9
WAS,30,SD,24,6,1,2013110305,2013,9
OAK,20,PHI,49,-29,0,2013110306,2013,9
SEA,27,TB,24,3,1,2013110307,2013,9
CLE,24,BAL,18,6,1,2013110308,2013,9
NE,55,PIT,31,24,1,2013110309,2013,9
HOU,24,IND,27,-3,0,2013110310,2013,9
GB,20,CHI,27,-7,0,2013110400,2013,9
MIN,34,WAS,27,7,1,2013110700,2013,10
ATL,10,SEA,33,-23,0,2013111000,2013,10
BAL,20,CIN,17,3,1,2013111001,2013,10
CHI,19,DET,21,-2,0,2013111002,2013,10
GB,13,PHI,27,-14,0,2013111003,2013,10
IND,8,STL,38,-30,0,2013111004,2013,10
NYG,24,OAK,20,4,1,2013111005,2013,10
PIT,23,BUF,10,13,1,2013111006,2013,10
TEN,27,JAC,29,-2,0,2013111007,2013,10
SF,9,CAR,10,-1,0,2013111008,2013,10
ARI,27,HOU,24,3,1,2013111009,2013,10
SD,20,DEN,28,-8,0,2013111010,2013,10
NO,49,DAL,17,32,1,2013111011,2013,10
TB,22,MIA,19,3,1,2013111100,2013,10
TEN,27,IND,30,-3,0,2013111400,2013,11
BUF,37,NYJ,14,23,1,2013111700,2013,11
CHI,23,BAL,20,3,1,2013111701,2013,11
CIN,41,CLE,20,21,1,2013111702,2013,11
HOU,23,OAK,28,-5,0,2013111703,2013,11
JAC,14,ARI,27,-13,0,2013111704,2013,11
MIA,20,SD,16,4,1,2013111705,2013,11
PHI,24,WAS,16,8,1,2013111706,2013,11
PIT,37,DET,27,10,1,2013111707,2013,11
TB,41,ATL,28,13,1,2013111708,2013,11
DEN,27,KC,17,10,1,2013111709,2013,11
NO,23,SF,20,3,1,2013111710,2013,11
SEA,41,MIN,20,21,1,2013111711,2013,11
NYG,27,GB,13,14,1,2013111712,2013,11
CAR,24,NE,20,4,1,2013111800,2013,11
ATL,13,NO,17,-4,0,2013112100,2013,12
BAL,19,NYJ,3,16,1,2013112400,2013,12
CLE,11,PIT,27,-16,0,2013112401,2013,12
DET,21,TB,24,-3,0,2013112402,2013,12
GB,26,MIN,26,0,0,2013112403,2013,12
HOU,6,JAC,13,-7,0,2013112404,2013,12
KC,38,SD,41,-3,0,2013112405,2013,12
MIA,16,CAR,20,-4,0,2013112406,2013,12
STL,42,CHI,21,21,1,2013112407,2013,12
ARI,40,IND,11,29,1,2013112408,2013,12
OAK,19,TEN,23,-4,0,2013112409,2013,12
NYG,21,DAL,24,-3,0,2013112410,2013,12
NE,34,DEN,31,3,1,2013112411,2013,12
WAS,6,SF,27,-21,0,2013112500,2013,12
DET,40,GB,10,30,1,2013112800,2013,13
DAL,31,OAK,24,7,1,2013112801,2013,13
BAL,22,PIT,20,2,1,2013112802,2013,13
CAR,27,TB,6,21,1,2013120100,2013,13
CLE,28,JAC,32,-4,0,2013120101,2013,13
IND,22,TEN,14,8,1,2013120102,2013,13
KC,28,DEN,35,-7,0,2013120103,2013,13
MIN,23,CHI,20,3,1,2013120104,2013,13
NYJ,3,MIA,23,-20,0,2013120105,2013,13
PHI,24,ARI,21,3,1,2013120106,2013,13
BUF,31,ATL,34,-3,0,2013120107,2013,13
SF,23,STL,13,10,1,2013120108,2013,13
HOU,31,NE,34,-3,0,2013120109,2013,13
SD,10,CIN,17,-7,0,2013120110,2013,13
WAS,17,NYG,24,-7,0,2013120111,2013,13
SEA,34,NO,7,27,1,2013120200,2013,13
JAC,27,HOU,20,7,1,2013120500,2013,14
BAL,29,MIN,26,3,1,2013120800,2013,14
CIN,42,IND,28,14,1,2013120801,2013,14
NE,27,CLE,26,1,1,2013120802,2013,14
NYJ,37,OAK,27,10,1,2013120803,2013,14
NO,31,CAR,13,18,1,2013120804,2013,14
PHI,34,DET,20,14,1,2013120805,2013,14
PIT,28,MIA,34,-6,0,2013120806,2013,14
TB,27,BUF,6,21,1,2013120807,2013,14
WAS,10,KC,45,-35,0,2013120808,2013,14
DEN,51,TEN,28,23,1,2013120809,2013,14
ARI,30,STL,10,20,1,2013120810,2013,14
SD,37,NYG,14,23,1,2013120811,2013,14
SF,19,SEA,17,2,1,2013120812,2013,14
GB,22,ATL,21,1,1,2013120813,2013,14
CHI,45,DAL,28,17,1,2013120900,2013,14
DEN,20,SD,27,-7,0,2013121200,2013,15
ATL,27,WAS,26,1,1,2013121500,2013,15
CLE,31,CHI,38,-7,0,2013121501,2013,15
IND,25,HOU,3,22,1,2013121502,2013,15
JAC,20,BUF,27,-7,0,2013121503,2013,15
MIA,24,NE,20,4,1,2013121504,2013,15
MIN,48,PHI,30,18,1,2013121505,2013,15
NYG,0,SEA,23,-23,0,2013121506,2013,15
STL,27,NO,16,11,1,2013121507,2013,15
TB,14,SF,33,-19,0,2013121508,2013,15
TEN,34,ARI,37,-3,0,2013121509,2013,15
CAR,30,NYJ,20,10,1,2013121510,2013,15
OAK,31,KC,56,-25,0,2013121511,2013,15
DAL,36,GB,37,-1,0,2013121512,2013,15
PIT,30,CIN,20,10,1,2013121513,2013,15
DET,16,BAL,18,-2,0,2013121600,2013,15
BUF,19,MIA,0,19,1,2013122200,2013,16
CAR,17,NO,13,4,1,2013122201,2013,16
CIN,42,MIN,14,28,1,2013122202,2013,16
HOU,13,DEN,37,-24,0,2013122203,2013,16
JAC,16,TEN,20,-4,0,2013122204,2013,16
KC,7,IND,23,-16,0,2013122205,2013,16
NYJ,24,CLE,13,11,1,2013122206,2013,16
PHI,54,CHI,11,43,1,2013122207,2013,16
STL,23,TB,13,10,1,2013122208,2013,16
WAS,23,DAL,24,-1,0,2013122209,2013,16
DET,20,NYG,23,-3,0,2013122210,2013,16
SEA,10,ARI,17,-7,0,2013122211,2013,16
GB,31,PIT,38,-7,0,2013122212,2013,16
SD,26,OAK,13,13,1,2013122213,2013,16
BAL,7,NE,41,-34,0,2013122214,2013,16
SF,34,ATL,24,10,1,2013122300,2013,16
ATL,20,CAR,21,-1,0,2013122900,2013,17
CHI,28,GB,33,-5,0,2013122901,2013,17
CIN,34,BAL,17,17,1,2013122902,2013,17
DAL,22,PHI,24,-2,0,2013122903,2013,17
IND,30,JAC,10,20,1,2013122904,2013,17
MIA,7,NYJ,20,-13,0,2013122905,2013,17
MIN,14,DET,13,1,1,2013122906,2013,17
NE,34,BUF,20,14,1,2013122907,2013,17
NO,42,TB,17,25,1,2013122908,2013,17
NYG,20,WAS,6,14,1,2013122909,2013,17
PIT,20,CLE,7,13,1,2013122910,2013,17
TEN,16,HOU,10,6,1,2013122911,2013,17
ARI,20,SF,23,-3,0,2013122912,2013,17
OAK,14,DEN,34,-20,0,2013122913,2013,17
SD,27,KC,24,3,1,2013122914,2013,17
SEA,27,STL,9,18,1,2013122915,2013,17
SEA,36,GB,16,20,1,2014090400,2014,1
ATL,37,NO,34,3,1,2014090700,2014,1
BAL,16,CIN,23,-7,0,2014090701,2014,1
CHI,20,BUF,23,-3,0,2014090702,2014,1
HOU,17,WAS,6,11,1,2014090703,2014,1
KC,10,TEN,26,-16,0,2014090704,2014,1
MIA,33,NE,20,13,1,2014090705,2014,1
NYJ,19,OAK,14,5,1,2014090706,2014,1
PHI,34,JAC,17,17,1,2014090707,2014,1
PIT,30,CLE,27,3,1,2014090708,2014,1
STL,6,MIN,34,-28,0,2014090709,2014,1
DAL,17,SF,28,-11,0,2014090710,2014,1
TB,14,CAR,20,-6,0,2014090711,2014,1
DEN,31,IND,24,7,1,2014090712,2014,1
DET,35,NYG,14,21,1,2014090800,2014,1
ARI,18,SD,17,1,1,2014090801,2014,1
BAL,26,PIT,6,20,1,2014091100,2014,2
BUF,29,MIA,10,19,1,2014091400,2014,2
CAR,24,DET,7,17,1,2014091401,2014,2
CIN,24,ATL,10,14,1,2014091402,2014,2
CLE,26,NO,24,2,1,2014091403,2014,2
MIN,7,NE,30,-23,0,2014091404,2014,2
NYG,14,ARI,25,-11,0,2014091405,2014,2
TEN,10,DAL,26,-16,0,2014091406,2014,2
WAS,41,JAC,10,31,1,2014091407,2014,2
SD,30,SEA,21,9,1,2014091408,2014,2
TB,17,STL,19,-2,0,2014091409,2014,2
DEN,24,KC,17,7,1,2014091410,2014,2
GB,31,NYJ,24,7,1,2014091411,2014,2
OAK,14,HOU,30,-16,0,2014091412,2014,2
SF,20,CHI,28,-8,0,2014091413,2014,2
IND,27,PHI,30,-3,0,2014091500,2014,2
ATL,56,TB,14,42,1,2014091800,2014,3
BUF,10,SD,22,-12,0,2014092100,2014,3
CIN,33,TEN,7,26,1,2014092101,2014,3
CLE,21,BAL,23,-2,0,2014092102,2014,3
DET,19,GB,7,12,1,2014092103,2014,3
JAC,17,IND,44,-27,0,2014092104,2014,3
NE,16,OAK,9,7,1,2014092105,2014,3
NO,20,MIN,9,11,1,2014092106,2014,3
NYG,30,HOU,17,13,1,2014092107,2014,3
PHI,37,WAS,34,3,1,2014092108,2014,3
STL,31,DAL,34,-3,0,2014092109,2014,3
ARI,23,SF,14,9,1,2014092110,2014,3
MIA,15,KC,34,-19,0,2014092111,2014,3
SEA,26,DEN,20,6,1,2014092112,2014,3
CAR,19,PIT,37,-18,0,2014092113,2014,3
NYJ,19,CHI,27,-8,0,2014092200,2014,3
WAS,14,NYG,45,-31,0,2014092500,2014,4
BAL,38,CAR,10,28,1,2014092800,2014,4
CHI,17,GB,38,-21,0,2014092801,2014,4
HOU,23,BUF,17,6,1,2014092802,2014,4
IND,41,TEN,17,24,1,2014092803,2014,4
MIN,41,ATL,28,13,1,2014092804,2014,4
NYJ,17,DET,24,-7,0,2014092805,2014,4
OAK,14,MIA,38,-24,0,2014092806,2014,4
PIT,24,TB,27,-3,0,2014092807,2014,4
SD,33,JAC,14,19,1,2014092808,2014,4
SF,26,PHI,21,5,1,2014092809,2014,4
DAL,38,NO,17,21,1,2014092810,2014,4
KC,41,NE,14,27,1,2014092900,2014,4
GB,42,MIN,10,32,1,2014100200,2014,5
CAR,31,CHI,24,7,1,2014100500,2014,5
DAL,20,HOU,17,3,1,2014100501,2014,5
DET,14,BUF,17,-3,0,2014100502,2014,5
IND,20,BAL,13,7,1,2014100503,2014,5
JAC,9,PIT,17,-8,0,2014100504,2014,5
NO,37,TB,31,6,1,2014100505,2014,5
NYG,30,ATL,20,10,1,2014100506,2014,5
PHI,34,STL,28,6,1,2014100507,2014,5
TEN,28,CLE,29,-1,0,2014100508,2014,5
DEN,41,ARI,20,21,1,2014100509,2014,5
SD,31,NYJ,0,31,1,2014100510,2014,5
SF,22,KC,17,5,1,2014100511,2014,5
NE,43,CIN,17,26,1,2014100512,2014,5
WAS,17,SEA,27,-10,0,2014100600,2014,5
HOU,28,IND,33,-5,0,2014100900,2014,6
ATL,13,CHI,27,-14,0,2014101200,2014,6
BUF,22,NE,37,-15,0,2014101201,2014,6
CIN,37,CAR,37,0,0,2014101202,2014,6
CLE,31,PIT,10,21,1,2014101203,2014,6
MIA,24,GB,27,-3,0,2014101204,2014,6
MIN,3,DET,17,-14,0,2014101205,2014,6
NYJ,17,DEN,31,-14,0,2014101206,2014,6
TB,17,BAL,48,-31,0,2014101207,2014,6
TEN,16,JAC,14,2,1,2014101208,2014,6
OAK,28,SD,31,-3,0,2014101209,2014,6
ARI,30,WAS,20,10,1,2014101210,2014,6
SEA,23,DAL,30,-7,0,2014101211,2014,6
PHI,27,NYG,0,27,1,2014101212,2014,6
STL,17,SF,31,-14,0,2014101300,2014,6
NE,27,NYJ,25,2,1,2014101600,2014,7
BAL,29,ATL,7,22,1,2014101900,2014,7
BUF,17,MIN,16,1,1,2014101901,2014,7
CHI,14,MIA,27,-13,0,2014101902,2014,7
DET,24,NO,23,1,1,2014101903,2014,7
GB,38,CAR,17,21,1,2014101904,2014,7
IND,27,CIN,0,27,1,2014101905,2014,7
JAC,24,CLE,6,18,1,2014101906,2014,7
STL,28,SEA,26,2,1,2014101907,2014,7
WAS,19,TEN,17,2,1,2014101908,2014,7
SD,20,KC,23,-3,0,2014101909,2014,7
DAL,31,NYG,21,10,1,2014101910,2014,7
OAK,13,ARI,24,-11,0,2014101911,2014,7
DEN,42,SF,17,25,1,2014101912,2014,7
PIT,30,HOU,23,7,1,2014102000,2014,7
DEN,35,SD,21,14,1,2014102300,2014,8
ATL,21,DET,22,-1,0,2014102600,2014,8
CAR,9,SEA,13,-4,0,2014102601,2014,8
CIN,27,BAL,24,3,1,2014102602,2014,8
JAC,13,MIA,27,-14,0,2014102603,2014,8
KC,34,STL,7,27,1,2014102604,2014,8
NE,51,CHI,23,28,1,2014102605,2014,8
NYJ,23,BUF,43,-20,0,2014102606,2014,8
TB,13,MIN,19,-6,0,2014102607,2014,8
TEN,16,HOU,30,-14,0,2014102608,2014,8
ARI,24,PHI,20,4,1,2014102609,2014,8
CLE,23,OAK,13,10,1,2014102610,2014,8
PIT,51,IND,34,17,1,2014102611,2014,8
NO,44,GB,23,21,1,2014102612,2014,8
DAL,17,WAS,20,-3,0,2014102700,2014,8
CAR,10,NO,28,-18,0,2014103000,2014,9
CIN,33,JAC,23,10,1,2014110200,2014,9
CLE,22,TB,17,5,1,2014110201,2014,9
DAL,17,ARI,28,-11,0,2014110202,2014,9
HOU,21,PHI,31,-10,0,2014110203,2014,9
KC,24,NYJ,10,14,1,2014110204,2014,9
MIA,37,SD,0,37,1,2014110205,2014,9
MIN,29,WAS,26,3,1,2014110206,2014,9
SF,10,STL,13,-3,0,2014110207,2014,9
NE,43,DEN,21,22,1,2014110208,2014,9
SEA,30,OAK,24,6,1,2014110209,2014,9
PIT,36,BAL,23,13,1,2014110210,2014,9
NYG,24,IND,40,-16,0,2014110300,2014,9
CIN,3,CLE,24,-21,0,2014110600,2014,10
BAL,21,TEN,7,14,1,2014110900,2014,10
BUF,13,KC,17,-4,0,2014110901,2014,10
DET,20,MIA,16,4,1,2014110902,2014,10
JAC,17,DAL,31,-14,0,2014110903,2014,10
NO,24,SF,27,-3,0,2014110904,2014,10
NYJ,20,PIT,13,7,1,2014110905,2014,10
TB,17,ATL,27,-10,0,2014110906,2014,10
OAK,17,DEN,41,-24,0,2014110907,2014,10
ARI,31,STL,14,17,1,2014110908,2014,10
SEA,38,NYG,17,21,1,2014110909,2014,10
GB,55,CHI,14,41,1,2014110910,2014,10
PHI,45,CAR,21,24,1,2014111000,2014,10
MIA,22,BUF,9,13,1,2014111300,2014,11
CAR,17,ATL,19,-2,0,2014111600,2014,11
CHI,21,MIN,13,8,1,2014111601,2014,11
CLE,7,HOU,23,-16,0,2014111602,2014,11
GB,53,PHI,20,33,1,2014111603,2014,11
KC,24,SEA,20,4,1,2014111604,2014,11
NO,10,CIN,27,-17,0,2014111605,2014,11
NYG,10,SF,16,-6,0,2014111606,2014,11
STL,22,DEN,7,15,1,2014111607,2014,11
WAS,7,TB,27,-20,0,2014111608,2014,11
SD,13,OAK,6,7,1,2014111609,2014,11
ARI,14,DET,6,8,1,2014111610,2014,11
IND,20,NE,42,-22,0,2014111611,2014,11
TEN,24,PIT,27,-3,0,2014111700,2014,11
OAK,24,KC,20,4,1,2014112000,2014,12
ATL,24,CLE,26,-2,0,2014112300,2014,12
BUF,38,NYJ,3,35,1,2014112301,2014,12
CHI,21,TB,13,8,1,2014112302,2014,12
HOU,13,CIN,22,-9,0,2014112303,2014,12
IND,23,JAC,3,20,1,2014112304,2014,12
MIN,21,GB,24,-3,0,2014112305,2014,12
NE,34,DET,9,25,1,2014112306,2014,12
PHI,43,TEN,24,19,1,2014112307,2014,12
SD,27,STL,24,3,1,2014112308,2014,12
SEA,19,ARI,3,16,1,2014112309,2014,12
DEN,39,MIA,36,3,1,2014112310,2014,12
SF,17,WAS,13,4,1,2014112311,2014,12
NYG,28,DAL,31,-3,0,2014112312,2014,12
NO,27,BAL,34,-7,0,2014112400,2014,12
DET,34,CHI,17,17,1,2014112700,2014,13
DAL,10,PHI,33,-23,0,2014112701,2014,13
SF,3,SEA,19,-16,0,2014112702,2014,13
BAL,33,SD,34,-1,0,2014113000,2014,13
BUF,26,CLE,10,16,1,2014113001,2014,13
HOU,45,TEN,21,24,1,2014113002,2014,13
IND,49,WAS,27,22,1,2014113003,2014,13
JAC,25,NYG,24,1,1,2014113004,2014,13
MIN,31,CAR,13,18,1,2014113005,2014,13
PIT,32,NO,35,-3,0,2014113006,2014,13
STL,52,OAK,0,52,1,2014113007,2014,13
TB,13,CIN,14,-1,0,2014113008,2014,13
ATL,29,ARI,18,11,1,2014113009,2014,13
GB,26,NE,21,5,1,2014113010,2014,13
KC,16,DEN,29,-13,0,2014113011,2014,13
NYJ,13,MIA,16,-3,0,2014120100,2014,13
CHI,28,DAL,41,-13,0,2014120400,2014,14
CIN,21,PIT,42,-21,0,2014120700,2014,14
CLE,24,IND,25,-1,0,2014120701,2014,14
DET,34,TB,17,17,1,2014120702,2014,14
JAC,13,HOU,27,-14,0,2014120703,2014,14
MIA,13,BAL,28,-15,0,2014120704,2014,14
MIN,30,NYJ,24,6,1,2014120705,2014,14
NO,10,CAR,41,-31,0,2014120706,2014,14
TEN,7,NYG,36,-29,0,2014120707,2014,14
WAS,0,STL,24,-24,0,2014120708,2014,14
ARI,17,KC,14,3,1,2014120709,2014,14
DEN,24,BUF,17,7,1,2014120710,2014,14
OAK,24,SF,13,11,1,2014120711,2014,14
PHI,14,SEA,24,-10,0,2014120712,2014,14
SD,14,NE,23,-9,0,2014120713,2014,14
GB,43,ATL,37,6,1,2014120800,2014,14
STL,6,ARI,12,-6,0,2014121100,2014,15
ATL,20,PIT,27,-7,0,2014121400,2014,15
BAL,20,JAC,12,8,1,2014121401,2014,15
BUF,21,GB,13,8,1,2014121402,2014,15
CAR,19,TB,17,2,1,2014121403,2014,15
CLE,0,CIN,30,-30,0,2014121404,2014,15
DET,16,MIN,14,2,1,2014121405,2014,15
IND,17,HOU,10,7,1,2014121406,2014,15
KC,31,OAK,13,18,1,2014121407,2014,15
NE,41,MIA,13,28,1,2014121408,2014,15
NYG,24,WAS,13,11,1,2014121409,2014,15
SD,10,DEN,22,-12,0,2014121410,2014,15
TEN,11,NYJ,16,-5,0,2014121411,2014,15
SEA,17,SF,7,10,1,2014121412,2014,15
PHI,27,DAL,38,-11,0,2014121413,2014,15
CHI,15,NO,31,-16,0,2014121500,2014,15
JAC,21,TEN,13,8,1,2014121800,2014,16
WAS,27,PHI,24,3,1,2014122000,2014,16
SF,35,SD,38,-3,0,2014122001,2014,16
CAR,17,CLE,13,4,1,2014122100,2014,16
CHI,14,DET,20,-6,0,2014122101,2014,16
HOU,25,BAL,13,12,1,2014122102,2014,16
MIA,37,MIN,35,2,1,2014122103,2014,16
NO,14,ATL,30,-16,0,2014122104,2014,16
NYJ,16,NE,17,-1,0,2014122105,2014,16
PIT,20,KC,12,8,1,2014122106,2014,16
TB,3,GB,20,-17,0,2014122107,2014,16
STL,27,NYG,37,-10,0,2014122108,2014,16
DAL,42,IND,7,35,1,2014122109,2014,16
OAK,26,BUF,24,2,1,2014122110,2014,16
ARI,6,SEA,35,-29,0,2014122111,2014,16
CIN,37,DEN,28,9,1,2014122200,2014,16
ATL,3,CAR,34,-31,0,2014122800,2014,17
BAL,20,CLE,10,10,1,2014122801,2014,17
GB,30,DET,20,10,1,2014122802,2014,17
HOU,23,JAC,17,6,1,2014122803,2014,17
KC,19,SD,7,12,1,2014122804,2014,17
MIA,24,NYJ,37,-13,0,2014122805,2014,17
MIN,13,CHI,9,4,1,2014122806,2014,17
NE,9,BUF,17,-8,0,2014122807,2014,17
NYG,26,PHI,34,-8,0,2014122808,2014,17
PIT,27,CIN,17,10,1,2014122809,2014,17
TB,20,NO,23,-3,0,2014122810,2014,17
TEN,10,IND,27,-17,0,2014122811,2014,17
WAS,17,DAL,44,-27,0,2014122812,2014,17
DEN,47,OAK,14,33,1,2014122813,2014,17
SF,20,ARI,17,3,1,2014122814,2014,17
SEA,20,STL,6,14,1,2014122815,2014,17
NE,28,PIT,21,7,1,2015091000,2015,1
CHI,23,GB,31,-8,0,2015091300,2015,1
STL,34,SEA,31,3,1,2015091301,2015,1
JAC,9,CAR,20,-11,0,2015091302,2015,1
WAS,10,MIA,17,-7,0,2015091303,2015,1
BUF,27,IND,14,13,1,2015091304,2015,1
NYJ,31,CLE,10,21,1,2015091305,2015,1
HOU,20,KC,27,-7,0,2015091306,2015,1
ARI,31,NO,19,12,1,2015091307,2015,1
SD,33,DET,28,5,1,2015091308,2015,1
DEN,19,BAL,13,6,1,2015091309,2015,1
OAK,13,CIN,33,-20,0,2015091310,2015,1
TB,14,TEN,42,-28,0,2015091311,2015,1
DAL,27,NYG,26,1,1,2015091312,2015,1
ATL,26,PHI,24,2,1,2015091400,2015,1
SF,20,MIN,3,17,1,2015091401,2015,1
KC,24,DEN,31,-7,0,2015091700,2015,2
CAR,24,HOU,17,7,1,2015092000,2015,2
BUF,32,NE,40,-8,0,2015092001,2015,2
CIN,24,SD,19,5,1,2015092002,2015,2
CLE,28,TEN,14,14,1,2015092003,2015,2
NYG,20,ATL,24,-4,0,2015092004,2015,2
WAS,24,STL,10,14,1,2015092005,2015,2
CHI,23,ARI,48,-25,0,2015092006,2015,2
MIN,26,DET,16,10,1,2015092007,2015,2
NO,19,TB,26,-7,0,2015092008,2015,2
PIT,43,SF,18,25,1,2015092009,2015,2
OAK,37,BAL,33,4,1,2015092010,2015,2
JAC,23,MIA,20,3,1,2015092011,2015,2
PHI,10,DAL,20,-10,0,2015092012,2015,2
GB,27,SEA,17,10,1,2015092013,2015,2
IND,7,NYJ,20,-13,0,2015092100,2015,2
NYG,32,WAS,21,11,1,2015092400,2015,3
DAL,28,ATL,39,-11,0,2015092700,2015,3
CAR,27,NO,22,5,1,2015092701,2015,3
NYJ,17,PHI,24,-7,0,2015092702,2015,3
HOU,19,TB,9,10,1,2015092703,2015,3
MIN,31,SD,14,17,1,2015092704,2015,3
STL,6,PIT,12,-6,0,2015092705,2015,3
NE,51,JAC,17,34,1,2015092706,2015,3
BAL,24,CIN,28,-4,0,2015092707,2015,3
CLE,20,OAK,27,-7,0,2015092708,2015,3
TEN,33,IND,35,-2,0,2015092709,2015,3
ARI,47,SF,7,40,1,2015092710,2015,3
SEA,26,CHI,0,26,1,2015092711,2015,3
MIA,14,BUF,41,-27,0,2015092712,2015,3
DET,12,DEN,24,-12,0,2015092713,2015,3
GB,38,KC,28,10,1,2015092800,2015,3
PIT,20,BAL,23,-3,0,2015100100,2015,4
MIA,14,NYJ,27,-13,0,2015100400,2015,4
CHI,22,OAK,20,2,1,2015100401,2015,4
ATL,48,HOU,21,27,1,2015100402,2015,4
CIN,36,KC,21,15,1,2015100403,2015,4
IND,16,JAC,13,3,1,2015100404,2015,4
WAS,23,PHI,20,3,1,2015100405,2015,4
TB,23,CAR,37,-14,0,2015100406,2015,4
BUF,10,NYG,24,-14,0,2015100407,2015,4
SD,30,CLE,27,3,1,2015100408,2015,4
SF,3,GB,17,-14,0,2015100409,2015,4
ARI,22,STL,24,-2,0,2015100410,2015,4
DEN,23,MIN,20,3,1,2015100411,2015,4
NO,26,DAL,20,6,1,2015100412,2015,4
SEA,13,DET,10,3,1,2015100500,2015,4
HOU,20,IND,27,-7,0,2015100800,2015,5
KC,17,CHI,18,-1,0,2015101101,2015,5
CIN,27,SEA,24,3,1,2015101102,2015,5
ATL,25,WAS,19,6,1,2015101103,2015,5
TB,38,JAC,31,7,1,2015101104,2015,5
PHI,39,NO,17,22,1,2015101100,2015,5
BAL,30,CLE,33,-3,0,2015101105,2015,5
TEN,13,BUF,14,-1,0,2015101106,2015,5
GB,24,STL,10,14,1,2015101107,2015,5
DET,17,ARI,42,-25,0,2015101108,2015,5
DAL,6,NE,30,-24,0,2015101109,2015,5
OAK,10,DEN,16,-6,0,2015101110,2015,5
NYG,30,SF,27,3,1,2015101111,2015,5
SD,20,PIT,24,-4,0,2015101200,2015,5
NO,31,ATL,21,10,1,2015101500,2015,6
NYJ,34,WAS,20,14,1,2015101801,2015,6
PIT,25,ARI,13,12,1,2015101802,2015,6
MIN,16,KC,10,6,1,2015101803,2015,6
BUF,21,CIN,34,-13,0,2015101804,2015,6
DET,37,CHI,34,3,1,2015101800,2015,6
CLE,23,DEN,26,-3,0,2015101805,2015,6
TEN,10,MIA,38,-28,0,2015101806,2015,6
JAC,20,HOU,31,-11,0,2015101807,2015,6
SEA,23,CAR,27,-4,0,2015101808,2015,6
GB,27,SD,20,7,1,2015101809,2015,6
SF,25,BAL,20,5,1,2015101810,2015,6
IND,27,NE,34,-7,0,2015101811,2015,6
PHI,27,NYG,7,20,1,2015101900,2015,6
SF,3,SEA,20,-17,0,2015102200,2015,7
JAC,34,BUF,31,3,1,2015102500,2015,7
STL,24,CLE,6,18,1,2015102501,2015,7
MIA,44,HOU,26,18,1,2015102502,2015,7
NE,30,NYJ,23,7,1,2015102503,2015,7
KC,23,PIT,13,10,1,2015102504,2015,7
WAS,31,TB,30,1,1,2015102505,2015,7
DET,19,MIN,28,-9,0,2015102506,2015,7
IND,21,NO,27,-6,0,2015102507,2015,7
TEN,7,ATL,10,-3,0,2015102508,2015,7
SD,29,OAK,37,-8,0,2015102509,2015,7
NYG,27,DAL,20,7,1,2015102510,2015,7
CAR,27,PHI,16,11,1,2015102511,2015,7
ARI,26,BAL,18,8,1,2015102600,2015,7
NE,36,MIA,7,29,1,2015102900,2015,8
KC,45,DET,10,35,1,2015110100,2015,8
BAL,29,SD,26,3,1,2015110101,2015,8
PIT,10,CIN,16,-6,0,2015110102,2015,8
HOU,20,TEN,6,14,1,2015110103,2015,8
CHI,20,MIN,23,-3,0,2015110104,2015,8
ATL,20,TB,23,-3,0,2015110105,2015,8
NO,52,NYG,49,3,1,2015110106,2015,8
STL,27,SF,6,21,1,2015110107,2015,8
CLE,20,ARI,34,-14,0,2015110108,2015,8
OAK,34,NYJ,20,14,1,2015110109,2015,8
DAL,12,SEA,13,-1,0,2015110110,2015,8
DEN,29,GB,10,19,1,2015110111,2015,8
CAR,29,IND,26,3,1,2015110200,2015,8
CIN,31,CLE,10,21,1,2015110500,2015,9
CAR,37,GB,29,8,1,2015110801,2015,9
NE,27,WAS,10,17,1,2015110802,2015,9
NO,28,TEN,34,-6,0,2015110803,2015,9
BUF,33,MIA,17,16,1,2015110804,2015,9
MIN,21,STL,18,3,1,2015110800,2015,9
NYJ,28,JAC,23,5,1,2015110805,2015,9
PIT,38,OAK,35,3,1,2015110806,2015,9
TB,18,NYG,32,-14,0,2015110807,2015,9
SF,17,ATL,16,1,1,2015110808,2015,9
IND,27,DEN,24,3,1,2015110809,2015,9
DAL,27,PHI,33,-6,0,2015110810,2015,9
SD,19,CHI,22,-3,0,2015110900,2015,9
NYJ,17,BUF,22,-5,0,2015111200,2015,10
GB,16,DET,18,-2,0,2015111501,2015,10
TB,10,DAL,6,4,1,2015111502,2015,10
TEN,10,CAR,27,-17,0,2015111503,2015,10
STL,13,CHI,37,-24,0,2015111504,2015,10
WAS,47,NO,14,33,1,2015111500,2015,10
PHI,19,MIA,20,-1,0,2015111505,2015,10
BAL,20,JAC,22,-2,0,2015111506,2015,10
PIT,30,CLE,9,21,1,2015111507,2015,10
OAK,14,MIN,30,-16,0,2015111508,2015,10
NYG,26,NE,27,-1,0,2015111509,2015,10
DEN,13,KC,29,-16,0,2015111510,2015,10
SEA,32,ARI,39,-7,0,2015111511,2015,10
CIN,6,HOU,10,-4,0,2015111600,2015,10
JAC,19,TEN,13,6,1,2015111900,2015,11
DET,18,OAK,13,5,1,2015112201,2015,11
ATL,21,IND,24,-3,0,2015112202,2015,11
HOU,24,NYJ,17,7,1,2015112203,2015,11
PHI,17,TB,45,-28,0,2015112204,2015,11
CHI,15,DEN,17,-2,0,2015112200,2015,11
MIN,13,GB,30,-17,0,2015112205,2015,11
CAR,44,WAS,16,28,1,2015112206,2015,11
MIA,14,DAL,24,-10,0,2015112207,2015,11
BAL,16,STL,13,3,1,2015112208,2015,11
ARI,34,CIN,31,3,1,2015112209,2015,11
SEA,29,SF,13,16,1,2015112210,2015,11
SD,3,KC,33,-30,0,2015112211,2015,11
NE,20,BUF,13,7,1,2015112300,2015,11
DET,45,PHI,14,31,1,2015112600,2015,12
DAL,14,CAR,33,-19,0,2015112601,2015,12
GB,13,CHI,17,-4,0,2015112602,2015,12
HOU,24,NO,6,18,1,2015112903,2015,12
CIN,31,STL,7,24,1,2015112902,2015,12
ATL,10,MIN,20,-10,0,2015112901,2015,12
WAS,20,NYG,14,6,1,2015112900,2015,12
IND,25,TB,12,13,1,2015112904,2015,12
NYJ,38,MIA,20,18,1,2015112905,2015,12
JAC,25,SD,31,-6,0,2015112906,2015,12
TEN,21,OAK,24,-3,0,2015112907,2015,12
KC,30,BUF,22,8,1,2015112908,2015,12
SF,13,ARI,19,-6,0,2015112909,2015,12
SEA,39,PIT,30,9,1,2015112910,2015,12
DEN,30,NE,24,6,1,2015112911,2015,12
CLE,27,BAL,33,-6,0,2015113000,2015,12
DET,23,GB,27,-4,0,2015120300,2015,13
NYG,20,NYJ,23,-3,0,2015120600,2015,13
BUF,30,HOU,21,9,1,2015120601,2015,13
MIA,15,BAL,13,2,1,2015120602,2015,13
CLE,3,CIN,37,-34,0,2015120603,2015,13
TEN,42,JAC,39,3,1,2015120604,2015,13
CHI,20,SF,26,-6,0,2015120605,2015,13
MIN,7,SEA,38,-31,0,2015120606,2015,13
NO,38,CAR,41,-3,0,2015120607,2015,13
TB,23,ATL,19,4,1,2015120608,2015,13
STL,3,ARI,27,-24,0,2015120609,2015,13
OAK,20,KC,34,-14,0,2015120610,2015,13
SD,3,DEN,17,-14,0,2015120611,2015,13
NE,28,PHI,35,-7,0,2015120612,2015,13
PIT,45,IND,10,35,1,2015120613,2015,13
WAS,16,DAL,19,-3,0,2015120700,2015,13
ARI,23,MIN,20,3,1,2015121000,2015,14
PHI,23,BUF,20,3,1,2015121300,2015,14
NYJ,30,TEN,8,22,1,2015121301,2015,14
CIN,20,PIT,33,-13,0,2015121302,2015,14
HOU,6,NE,27,-21,0,2015121303,2015,14
JAC,51,IND,16,35,1,2015121304,2015,14
KC,10,SD,3,7,1,2015121305,2015,14
CHI,21,WAS,24,-3,0,2015121306,2015,14
CAR,38,ATL,0,38,1,2015121307,2015,14
TB,17,NO,24,-7,0,2015121308,2015,14
STL,21,DET,14,7,1,2015121309,2015,14
CLE,24,SF,10,14,1,2015121310,2015,14
DEN,12,OAK,15,-3,0,2015121311,2015,14
GB,28,DAL,7,21,1,2015121312,2015,14
BAL,6,SEA,35,-29,0,2015121313,2015,14
MIA,24,NYG,31,-7,0,2015121400,2015,14
STL,31,TB,23,8,1,2015121700,2015,15
DAL,16,NYJ,19,-3,0,2015121900,2015,15
MIN,38,CHI,17,21,1,2015122002,2015,15
JAC,17,ATL,23,-6,0,2015122003,2015,15
IND,10,HOU,16,-6,0,2015122004,2015,15
PHI,17,ARI,40,-23,0,2015122001,2015,15
NYG,35,CAR,38,-3,0,2015122000,2015,15
NE,33,TEN,16,17,1,2015122005,2015,15
BAL,14,KC,34,-20,0,2015122006,2015,15
WAS,35,BUF,25,10,1,2015122007,2015,15
SEA,30,CLE,13,17,1,2015122008,2015,15
OAK,20,GB,30,-10,0,2015122009,2015,15
PIT,34,DEN,27,7,1,2015122010,2015,15
SD,30,MIA,14,16,1,2015122011,2015,15
SF,14,CIN,24,-10,0,2015122012,2015,15
NO,27,DET,35,-8,0,2015122100,2015,15
OAK,23,SD,20,3,1,2015122400,2015,16
PHI,24,WAS,38,-14,0,2015122600,2015,16
NYJ,26,NE,20,6,1,2015122702,2015,16
TEN,6,HOU,34,-28,0,2015122703,2015,16
KC,17,CLE,13,4,1,2015122704,2015,16
MIA,12,IND,18,-6,0,2015122701,2015,16
NO,38,JAC,27,11,1,2015122700,2015,16
DET,32,SF,17,15,1,2015122705,2015,16
MIN,49,NYG,17,32,1,2015122706,2015,16
ATL,20,CAR,13,7,1,2015122707,2015,16
TB,21,CHI,26,-5,0,2015122708,2015,16
BUF,16,DAL,6,10,1,2015122709,2015,16
ARI,38,GB,8,30,1,2015122710,2015,16
SEA,17,STL,23,-6,0,2015122711,2015,16
BAL,20,PIT,17,3,1,2015122712,2015,16
DEN,20,CIN,17,3,1,2015122800,2015,16
BUF,22,NYJ,17,5,1,2016010300,2015,17
CIN,24,BAL,16,8,1,2016010302,2015,17
CLE,12,PIT,28,-16,0,2016010303,2015,17
HOU,30,JAC,6,24,1,2016010304,2015,17
IND,30,TEN,24,6,1,2016010305,2015,17
KC,23,OAK,17,6,1,2016010306,2015,17
DAL,23,WAS,34,-11,0,2016010307,2015,17
NYG,30,PHI,35,-5,0,2016010308,2015,17
CHI,20,DET,24,-4,0,2016010309,2015,17
GB,13,MIN,20,-7,0,2016010310,2015,17
ATL,17,NO,20,-3,0,2016010311,2015,17
CAR,38,TB,10,28,1,2016010312,2015,17
MIA,20,NE,10,10,1,2016010301,2015,17
SF,19,STL,16,3,1,2016010315,2015,17
DEN,27,SD,20,7,1,2016010313,2015,17
ARI,6,SEA,36,-30,0,2016010314,2015,17
DEN,21,CAR,20,1,1,2016090800,2016,1
ATL,24,TB,31,-7,0,2016091100,2016,1
BAL,13,BUF,7,6,1,2016091101,2016,1
HOU,23,CHI,14,9,1,2016091102,2016,1
JAX,23,GB,27,-4,0,2016091103,2016,1
KC,33,SD,27,6,1,2016091104,2016,1
NO,34,OAK,35,-1,0,2016091105,2016,1
NYJ,22,CIN,23,-1,0,2016091106,2016,1
PHI,29,CLE,10,19,1,2016091107,2016,1
TEN,16,MIN,25,-9,0,2016091108,2016,1
SEA,12,MIA,10,2,1,2016091109,2016,1
DAL,19,NYG,20,-1,0,2016091110,2016,1
IND,35,DET,39,-4,0,2016091111,2016,1
ARI,21,NE,23,-2,0,2016091112,2016,1
WAS,16,PIT,38,-22,0,2016091200,2016,1
SF,28,LA,0,28,1,2016091201,2016,1
BUF,31,NYJ,37,-6,0,2016091500,2016,2
CAR,46,SF,27,19,1,2016091800,2016,2
CLE,20,BAL,25,-5,0,2016091801,2016,2
DET,15,TEN,16,-1,0,2016091802,2016,2
HOU,19,KC,12,7,1,2016091803,2016,2
NE,31,MIA,24,7,1,2016091804,2016,2
NYG,16,NO,13,3,1,2016091805,2016,2
PIT,24,CIN,16,8,1,2016091806,2016,2
WAS,23,DAL,27,-4,0,2016091807,2016,2
ARI,40,TB,7,33,1,2016091808,2016,2
LA,9,SEA,3,6,1,2016091809,2016,2
DEN,34,IND,20,14,1,2016091810,2016,2
OAK,28,ATL,35,-7,0,2016091811,2016,2
SD,38,JAX,14,24,1,2016091812,2016,2
MIN,17,GB,14,3,1,2016091813,2016,2
CHI,14,PHI,29,-15,0,2016091900,2016,2
NE,27,HOU,0,27,1,2016092200,2016,3
BUF,33,ARI,18,15,1,2016092500,2016,3
CAR,10,MIN,22,-12,0,2016092501,2016,3
CIN,17,DEN,29,-12,0,2016092502,2016,3
GB,34,DET,27,7,1,2016092503,2016,3
JAX,17,BAL,19,-2,0,2016092504,2016,3
MIA,30,CLE,24,6,1,2016092505,2016,3
NYG,27,WAS,29,-2,0,2016092506,2016,3
TEN,10,OAK,17,-7,0,2016092507,2016,3
SEA,37,SF,18,19,1,2016092508,2016,3
TB,32,LA,37,-5,0,2016092509,2016,3
PHI,34,PIT,3,31,1,2016092510,2016,3
IND,26,SD,22,4,1,2016092511,2016,3
KC,24,NYJ,3,21,1,2016092512,2016,3
DAL,31,CHI,17,14,1,2016092513,2016,3
NO,32,ATL,45,-13,0,2016092600,2016,3
CIN,22,MIA,7,15,1,2016092900,2016,4
JAX,30,IND,27,3,1,2016100200,2016,4
ATL,48,CAR,33,15,1,2016100201,2016,4
BAL,27,OAK,28,-1,0,2016100202,2016,4
CHI,17,DET,14,3,1,2016100203,2016,4
HOU,27,TEN,20,7,1,2016100204,2016,4
NE,0,BUF,16,-16,0,2016100205,2016,4
NYJ,17,SEA,27,-10,0,2016100206,2016,4
WAS,31,CLE,20,11,1,2016100207,2016,4
TB,7,DEN,27,-20,0,2016100208,2016,4
ARI,13,LA,17,-4,0,2016100209,2016,4
SD,34,NO,35,-1,0,2016100210,2016,4
SF,17,DAL,24,-7,0,2016100211,2016,4
PIT,43,KC,14,29,1,2016100212,2016,4
MIN,24,NYG,10,14,1,2016100300,2016,4
SF,21,ARI,33,-12,0,2016100600,2016,5
CLE,13,NE,33,-20,0,2016100901,2016,5
DET,24,PHI,23,1,1,2016100902,2016,5
IND,29,CHI,23,6,1,2016100903,2016,5
MIA,17,TEN,30,-13,0,2016100904,2016,5
BAL,10,WAS,16,-6,0,2016100900,2016,5
MIN,31,HOU,13,18,1,2016100905,2016,5
PIT,31,NYJ,13,18,1,2016100906,2016,5
DEN,16,ATL,23,-7,0,2016100907,2016,5
DAL,28,CIN,14,14,1,2016100908,2016,5
LA,19,BUF,30,-11,0,2016100909,2016,5
OAK,34,SD,31,3,1,2016100910,2016,5
GB,23,NYG,16,7,1,2016100911,2016,5
CAR,14,TB,17,-3,0,2016101000,2016,5
SD,21,DEN,13,8,1,2016101300,2016,6
BUF,45,SF,16,29,1,2016101600,2016,6
CHI,16,JAX,17,-1,0,2016101601,2016,6
DET,31,LA,28,3,1,2016101602,2016,6
MIA,30,PIT,15,15,1,2016101603,2016,6
NE,35,CIN,17,18,1,2016101604,2016,6
NO,41,CAR,38,3,1,2016101605,2016,6
NYG,27,BAL,23,4,1,2016101606,2016,6
TEN,28,CLE,26,2,1,2016101607,2016,6
WAS,27,PHI,20,7,1,2016101608,2016,6
OAK,10,KC,26,-16,0,2016101609,2016,6
GB,16,DAL,30,-14,0,2016101610,2016,6
SEA,26,ATL,24,2,1,2016101611,2016,6
HOU,26,IND,23,3,1,2016101612,2016,6
ARI,28,NYJ,3,25,1,2016101700,2016,6
GB,26,CHI,10,16,1,2016102000,2016,7
LA,10,NYG,17,-7,0,2016102300,2016,7
CIN,31,CLE,17,14,1,2016102301,2016,7
DET,20,WAS,17,3,1,2016102302,2016,7
JAX,16,OAK,33,-17,0,2016102303,2016,7
KC,27,NO,21,6,1,2016102304,2016,7
MIA,28,BUF,25,3,1,2016102305,2016,7
NYJ,24,BAL,16,8,1,2016102306,2016,7
PHI,21,MIN,10,11,1,2016102307,2016,7
TEN,26,IND,34,-8,0,2016102308,2016,7
ATL,30,SD,33,-3,0,2016102309,2016,7
SF,17,TB,34,-17,0,2016102310,2016,7
PIT,16,NE,27,-11,0,2016102311,2016,7
ARI,6,SEA,6,0,0,2016102312,2016,7
DEN,27,HOU,9,18,1,2016102400,2016,7
TEN,36,JAX,22,14,1,2016102700,2016,8
CIN,27,WAS,27,0,0,2016103000,2016,8
ATL,33,GB,32,1,1,2016103001,2016,8
BUF,25,NE,41,-16,0,2016103002,2016,8
CLE,28,NYJ,31,-3,0,2016103003,2016,8
HOU,20,DET,13,7,1,2016103004,2016,8
IND,14,KC,30,-16,0,2016103005,2016,8
NO,25,SEA,20,5,1,2016103006,2016,8
TB,24,OAK,30,-6,0,2016103007,2016,8
DEN,27,SD,19,8,1,2016103008,2016,8
CAR,30,ARI,20,10,1,2016103009,2016,8
DAL,29,PHI,23,6,1,2016103010,2016,8
CHI,20,MIN,10,10,1,2016103100,2016,8
TB,28,ATL,43,-15,0,2016110300,2016,9
BAL,21,PIT,14,7,1,2016110601,2016,9
CLE,10,DAL,35,-25,0,2016110602,2016,9
KC,19,JAX,14,5,1,2016110603,2016,9
MIA,27,NYJ,23,4,1,2016110604,2016,9
MIN,16,DET,22,-6,0,2016110605,2016,9
NYG,28,PHI,23,5,1,2016110606,2016,9
LA,10,CAR,13,-3,0,2016110607,2016,9
SF,23,NO,41,-18,0,2016110608,2016,9
GB,26,IND,31,-5,0,2016110609,2016,9
SD,43,TEN,35,8,1,2016110610,2016,9
OAK,30,DEN,20,10,1,2016110600,2016,9
SEA,31,BUF,25,6,1,2016110700,2016,9
BAL,28,CLE,7,21,1,2016111000,2016,10
JAX,21,HOU,24,-3,0,2016111302,2016,10
NO,23,DEN,25,-2,0,2016111303,2016,10
NYJ,6,LA,9,-3,0,2016111304,2016,10
PHI,24,ATL,15,9,1,2016111305,2016,10
CAR,17,KC,20,-3,0,2016111301,2016,10
TB,36,CHI,10,26,1,2016111306,2016,10
TEN,47,GB,25,22,1,2016111307,2016,10
WAS,26,MIN,20,6,1,2016111308,2016,10
SD,24,MIA,31,-7,0,2016111309,2016,10
ARI,23,SF,20,3,1,2016111310,2016,10
PIT,30,DAL,35,-5,0,2016111311,2016,10
NE,24,SEA,31,-7,0,2016111312,2016,10
NYG,21,CIN,20,1,1,2016111400,2016,10
CAR,23,NO,20,3,1,2016111700,2016,11
CLE,9,PIT,24,-15,0,2016112001,2016,11
DAL,27,BAL,17,10,1,2016112002,2016,11
DET,26,JAX,19,7,1,2016112003,2016,11
IND,24,TEN,17,7,1,2016112004,2016,11
CIN,12,BUF,16,-4,0,2016112000,2016,11
KC,17,TB,19,-2,0,2016112005,2016,11
MIN,30,ARI,24,6,1,2016112006,2016,11
NYG,22,CHI,16,6,1,2016112007,2016,11
LA,10,MIA,14,-4,0,2016112008,2016,11
SF,17,NE,30,-13,0,2016112009,2016,11
SEA,26,PHI,15,11,1,2016112010,2016,11
WAS,42,GB,24,18,1,2016112011,2016,11
OAK,27,HOU,20,7,1,2016112100,2016,11
DET,16,MIN,13,3,1,2016112400,2016,12
DAL,31,WAS,26,5,1,2016112401,2016,12
IND,7,PIT,28,-21,0,2016112402,2016,12
CHI,21,TEN,27,-6,0,2016112703,2016,12
BUF,28,JAX,21,7,1,2016112702,2016,12
BAL,19,CIN,14,5,1,2016112701,2016,12
ATL,38,ARI,19,19,1,2016112700,2016,12
CLE,13,NYG,27,-14,0,2016112704,2016,12
HOU,13,SD,21,-8,0,2016112705,2016,12
MIA,31,SF,24,7,1,2016112706,2016,12
NO,49,LA,21,28,1,2016112707,2016,12
TB,14,SEA,5,9,1,2016112708,2016,12
DEN,27,KC,24,3,1,2016112709,2016,12
OAK,35,CAR,32,3,1,2016112710,2016,12
NYJ,17,NE,22,-5,0,2016112711,2016,12
PHI,13,GB,27,-14,0,2016112800,2016,12
MIN,15,DAL,17,-2,0,2016120100,2016,13
ATL,28,KC,29,-1,0,2016120400,2016,13
BAL,38,MIA,6,32,1,2016120401,2016,13
CHI,26,SF,6,20,1,2016120402,2016,13
CIN,32,PHI,14,18,1,2016120403,2016,13
GB,21,HOU,13,8,1,2016120404,2016,13
JAX,10,DEN,20,-10,0,2016120405,2016,13
NE,26,LA,10,16,1,2016120406,2016,13
NO,13,DET,28,-15,0,2016120407,2016,13
OAK,38,BUF,24,14,1,2016120408,2016,13
ARI,31,WAS,23,8,1,2016120409,2016,13
PIT,24,NYG,14,10,1,2016120410,2016,13
SD,21,TB,28,-7,0,2016120411,2016,13
SEA,40,CAR,7,33,1,2016120412,2016,13
NYJ,10,IND,41,-31,0,2016120500,2016,13
KC,21,OAK,13,8,1,2016120800,2016,14
BUF,20,PIT,27,-7,0,2016121100,2016,14
CAR,28,SD,16,12,1,2016121101,2016,14
CLE,10,CIN,23,-13,0,2016121102,2016,14
DET,20,CHI,17,3,1,2016121103,2016,14
IND,17,HOU,22,-5,0,2016121104,2016,14
JAX,16,MIN,25,-9,0,2016121105,2016,14
MIA,26,ARI,23,3,1,2016121106,2016,14
PHI,22,WAS,27,-5,0,2016121107,2016,14
TB,16,NO,11,5,1,2016121108,2016,14
TEN,13,DEN,10,3,1,2016121109,2016,14
SF,17,NYJ,23,-6,0,2016121110,2016,14
GB,38,SEA,10,28,1,2016121111,2016,14
LA,14,ATL,42,-28,0,2016121112,2016,14
NYG,10,DAL,7,3,1,2016121113,2016,14
NE,30,BAL,23,7,1,2016121200,2016,14
SEA,24,LA,3,21,1,2016121500,2016,15
NYJ,13,MIA,34,-21,0,2016121700,2016,15
CHI,27,GB,30,-3,0,2016121802,2016,15
DAL,26,TB,20,6,1,2016121803,2016,15
HOU,21,JAX,20,1,1,2016121804,2016,15
BUF,33,CLE,13,20,1,2016121801,2016,15
BAL,27,PHI,26,1,1,2016121800,2016,15
KC,17,TEN,19,-2,0,2016121805,2016,15
MIN,6,IND,34,-28,0,2016121806,2016,15
NYG,17,DET,6,11,1,2016121807,2016,15
ARI,41,NO,48,-7,0,2016121808,2016,15
ATL,41,SF,13,28,1,2016121809,2016,15
DEN,3,NE,16,-13,0,2016121810,2016,15
SD,16,OAK,19,-3,0,2016121811,2016,15
CIN,20,PIT,24,-4,0,2016121812,2016,15
WAS,15,CAR,26,-11,0,2016121900,2016,15
PHI,24,NYG,19,5,1,2016122200,2016,16
BUF,31,MIA,34,-3,0,2016122400,2016,16
CAR,16,ATL,33,-17,0,2016122401,2016,16
CHI,21,WAS,41,-20,0,2016122402,2016,16
CLE,20,SD,17,3,1,2016122403,2016,16
GB,38,MIN,25,13,1,2016122404,2016,16
JAX,38,TEN,17,21,1,2016122405,2016,16
NE,41,NYJ,3,38,1,2016122406,2016,16
NO,31,TB,24,7,1,2016122407,2016,16
OAK,33,IND,25,8,1,2016122408,2016,16
SEA,31,ARI,34,-3,0,2016122410,2016,16
LA,21,SF,22,-1,0,2016122409,2016,16
HOU,12,CIN,10,2,1,2016122411,2016,16
PIT,31,BAL,27,4,1,2016122500,2016,16
KC,33,DEN,10,23,1,2016122501,2016,16
DAL,42,DET,21,21,1,2016122600,2016,16
ATL,38,NO,32,6,1,2017010100,2016,17
DET,24,GB,31,-7,0,2017010102,2016,17
IND,24,JAX,20,4,1,2017010103,2016,17
MIA,14,NE,35,-21,0,2017010104,2016,17
MIN,38,CHI,10,28,1,2017010105,2016,17
NYJ,30,BUF,10,20,1,2017010106,2016,17
PHI,27,DAL,13,14,1,2017010107,2016,17
PIT,27,CLE,24,3,1,2017010108,2016,17
TB,17,CAR,16,1,1,2017010109,2016,17
TEN,24,HOU,17,7,1,2017010110,2016,17
WAS,10,NYG,19,-9,0,2017010111,2016,17
CIN,27,BAL,10,17,1,2017010101,2016,17
SF,23,SEA,25,-2,0,2017010115,2016,17
DEN,24,OAK,6,18,1,2017010112,2016,17
LA,6,ARI,44,-38,0,2017010113,2016,17
SD,27,KC,37,-10,0,2017010114,2016,17
NE,27,KC,42,-15,0,2017090700,2017,1
BUF,21,NYJ,12,9,1,2017091000,2017,1
CHI,17,ATL,23,-6,0,2017091001,2017,1
CIN,0,BAL,20,-20,0,2017091002,2017,1
CLE,18,PIT,21,-3,0,2017091003,2017,1
DET,35,ARI,23,12,1,2017091004,2017,1
HOU,7,JAX,29,-22,0,2017091005,2017,1
MIA,20,TB,30,-10,0,2017111911,2017,1
TEN,16,OAK,26,-10,0,2017091007,2017,1
WAS,17,PHI,30,-13,0,2017091008,2017,1
LA,46,IND,9,37,1,2017091009,2017,1
GB,17,SEA,9,8,1,2017091010,2017,1
SF,3,CAR,23,-20,0,2017091011,2017,1
DAL,19,NYG,3,16,1,2017091012,2017,1
MIN,29,NO,19,10,1,2017091100,2017,1
DEN,24,LAC,21,3,1,2017091101,2017,1
CIN,9,HOU,13,-4,0,2017091400,2017,2
BAL,24,CLE,10,14,1,2017091700,2017,2
CAR,9,BUF,3,6,1,2017091701,2017,2
IND,13,ARI,16,-3,0,2017091702,2017,2
JAX,16,TEN,37,-21,0,2017091703,2017,2
KC,27,PHI,20,7,1,2017091704,2017,2
NO,20,NE,36,-16,0,2017091705,2017,2
PIT,26,MIN,9,17,1,2017091706,2017,2
TB,29,CHI,7,22,1,2017091707,2017,2
LAC,17,MIA,19,-2,0,2017091708,2017,2
OAK,45,NYJ,20,25,1,2017091709,2017,2
DEN,42,DAL,17,25,1,2017091710,2017,2
LA,20,WAS,27,-7,0,2017091711,2017,2
SEA,12,SF,9,3,1,2017091712,2017,2
ATL,34,GB,23,11,1,2017091713,2017,2
NYG,10,DET,24,-14,0,2017091800,2017,2
SF,39,LA,41,-2,0,2017092100,2017,3
JAX,44,BAL,7,37,1,2017092400,2017,3
BUF,26,DEN,16,10,1,2017092401,2017,3
CAR,13,NO,34,-21,0,2017092402,2017,3
CHI,23,PIT,17,6,1,2017092403,2017,3
DET,26,ATL,30,-4,0,2017092404,2017,3
IND,31,CLE,28,3,1,2017092405,2017,3
MIN,34,TB,17,17,1,2017092406,2017,3
NE,36,HOU,33,3,1,2017092407,2017,3
NYJ,20,MIA,6,14,1,2017092408,2017,3
PHI,27,NYG,24,3,1,2017092409,2017,3
TEN,33,SEA,27,6,1,2017092410,2017,3
GB,27,CIN,24,3,1,2017092411,2017,3
LAC,10,KC,24,-14,0,2017092412,2017,3
WAS,27,OAK,10,17,1,2017092413,2017,3
ARI,17,DAL,28,-11,0,2017092500,2017,3
GB,35,CHI,14,21,1,2017092800,2017,4
MIA,0,NO,20,-20,0,2017100100,2017,4
ATL,17,BUF,23,-6,0,2017100101,2017,4
BAL,9,PIT,26,-17,0,2017100102,2017,4
CLE,7,CIN,31,-24,0,2017100103,2017,4
DAL,30,LA,35,-5,0,2017100104,2017,4
HOU,57,TEN,14,43,1,2017100105,2017,4
MIN,7,DET,14,-7,0,2017100106,2017,4
NE,30,CAR,33,-3,0,2017100107,2017,4
NYJ,23,JAX,20,3,1,2017100108,2017,4
ARI,18,SF,15,3,1,2017100109,2017,4
LAC,24,PHI,26,-2,0,2017100110,2017,4
TB,25,NYG,23,2,1,2017100111,2017,4
DEN,16,OAK,10,6,1,2017100112,2017,4
SEA,46,IND,18,28,1,2017100113,2017,4
KC,29,WAS,20,9,1,2017100200,2017,4
TB,14,NE,19,-5,0,2017100500,2017,5
CLE,14,NYJ,17,-3,0,2017100801,2017,5
DET,24,CAR,27,-3,0,2017100802,2017,5
IND,26,SF,23,3,1,2017100803,2017,5
MIA,16,TEN,10,6,1,2017100804,2017,5
CIN,20,BUF,16,4,1,2017100800,2017,5
NYG,22,LAC,27,-5,0,2017100805,2017,5
PHI,34,ARI,7,27,1,2017100806,2017,5
PIT,9,JAX,30,-21,0,2017100807,2017,5
LA,10,SEA,16,-6,0,2017100808,2017,5
OAK,17,BAL,30,-13,0,2017100809,2017,5
DAL,31,GB,35,-4,0,2017100810,2017,5
HOU,34,KC,42,-8,0,2017100811,2017,5
CHI,17,MIN,20,-3,0,2017100900,2017,5
CAR,23,PHI,28,-5,0,2017101200,2017,6
BAL,24,CHI,27,-3,0,2017101501,2017,6
HOU,33,CLE,17,16,1,2017101502,2017,6
MIN,23,GB,10,13,1,2017101503,2017,6
NO,52,DET,38,14,1,2017101504,2017,6
ATL,17,MIA,20,-3,0,2017101500,2017,6
NYJ,17,NE,24,-7,0,2017101505,2017,6
WAS,26,SF,24,2,1,2017101506,2017,6
ARI,38,TB,33,5,1,2017101507,2017,6
JAX,17,LA,27,-10,0,2017101508,2017,6
KC,13,PIT,19,-6,0,2017101509,2017,6
OAK,16,LAC,17,-1,0,2017101510,2017,6
DEN,10,NYG,23,-13,0,2017101511,2017,6
TEN,36,IND,22,14,1,2017101600,2017,6
OAK,31,KC,30,1,1,2017101900,2017,7
BUF,30,TB,27,3,1,2017102200,2017,7
CHI,17,CAR,3,14,1,2017102201,2017,7
CLE,9,TEN,12,-3,0,2017102202,2017,7
GB,17,NO,26,-9,0,2017102203,2017,7
IND,0,JAX,27,-27,0,2017102204,2017,7
LA,33,ARI,0,33,1,2017102205,2017,7
MIA,31,NYJ,28,3,1,2017102206,2017,7
MIN,24,BAL,16,8,1,2017102207,2017,7
PIT,29,CIN,14,15,1,2017102208,2017,7
SF,10,DAL,40,-30,0,2017102209,2017,7
LAC,21,DEN,0,21,1,2017102210,2017,7
NYG,7,SEA,24,-17,0,2017102211,2017,7
NE,23,ATL,7,16,1,2017102212,2017,7
PHI,34,WAS,24,10,1,2017102300,2017,7
BAL,40,MIA,0,40,1,2017102600,2017,8
CLE,16,MIN,33,-17,0,2017102900,2017,8
BUF,34,OAK,14,20,1,2017102901,2017,8
CIN,24,IND,23,1,1,2017102902,2017,8
NE,21,LAC,13,8,1,2017102903,2017,8
NO,20,CHI,12,8,1,2017102904,2017,8
NYJ,20,ATL,25,-5,0,2017102905,2017,8
PHI,33,SF,10,23,1,2017102906,2017,8
TB,3,CAR,17,-14,0,2017102907,2017,8
SEA,41,HOU,38,3,1,2017102908,2017,8
WAS,19,DAL,33,-14,0,2017102909,2017,8
DET,15,PIT,20,-5,0,2017102910,2017,8
KC,29,DEN,19,10,1,2017103000,2017,8
NYJ,34,BUF,21,13,1,2017110200,2017,9
HOU,14,IND,20,-6,0,2017110501,2017,9
JAX,23,CIN,7,16,1,2017110502,2017,9
NO,30,TB,10,20,1,2017110503,2017,9
NYG,17,LA,51,-34,0,2017110504,2017,9
CAR,20,ATL,17,3,1,2017110500,2017,9
PHI,51,DEN,23,28,1,2017110505,2017,9
TEN,23,BAL,20,3,1,2017110506,2017,9
SF,10,ARI,20,-10,0,2017110507,2017,9
SEA,14,WAS,17,-3,0,2017110508,2017,9
DAL,28,KC,17,11,1,2017110509,2017,9
MIA,24,OAK,27,-3,0,2017110510,2017,9
GB,17,DET,30,-13,0,2017110600,2017,9
ARI,16,SEA,22,-6,0,2017110900,2017,10
CHI,16,GB,23,-7,0,2017111201,2017,10
DET,38,CLE,24,14,1,2017111202,2017,10
IND,17,PIT,20,-3,0,2017111203,2017,10
JAX,20,LAC,17,3,1,2017111204,2017,10
BUF,10,NO,47,-37,0,2017111200,2017,10
TB,15,NYJ,10,5,1,2017111205,2017,10
TEN,24,CIN,20,4,1,2017111206,2017,10
WAS,30,MIN,38,-8,0,2017111207,2017,10
LA,33,HOU,7,26,1,2017111208,2017,10
ATL,27,DAL,7,20,1,2017111209,2017,10
SF,31,NYG,21,10,1,2017111210,2017,10
DEN,16,NE,41,-25,0,2017111211,2017,10
CAR,45,MIA,21,24,1,2017111300,2017,10
PIT,40,TEN,17,23,1,2017111600,2017,11
CLE,7,JAX,19,-12,0,2017111901,2017,11
GB,0,BAL,23,-23,0,2017111902,2017,11
HOU,31,ARI,21,10,1,2017111903,2017,11
MIN,24,LA,7,17,1,2017111904,2017,11
CHI,24,DET,27,-3,0,2017111900,2017,11
NO,34,WAS,31,3,1,2017111905,2017,11
NYG,12,KC,9,3,1,2017111906,2017,11
LAC,54,BUF,24,30,1,2017111907,2017,11
DEN,17,CIN,20,-3,0,2017111908,2017,11
OAK,8,NE,33,-25,0,2017111909,2017,11
DAL,9,PHI,37,-28,0,2017111910,2017,11
SEA,31,ATL,34,-3,0,2017112000,2017,11
DET,23,MIN,30,-7,0,2017112300,2017,12
DAL,6,LAC,28,-22,0,2017112301,2017,12
WAS,20,NYG,10,10,1,2017112302,2017,12
KC,10,BUF,16,-6,0,2017112603,2017,12
IND,16,TEN,20,-4,0,2017112602,2017,12
CIN,30,CLE,16,14,1,2017112601,2017,12
ATL,34,TB,20,14,1,2017112600,2017,12
NE,35,MIA,17,18,1,2017112604,2017,12
NYJ,27,CAR,35,-8,0,2017112605,2017,12
PHI,31,CHI,3,28,1,2017112606,2017,12
LA,26,NO,20,6,1,2017112607,2017,12
SF,13,SEA,24,-11,0,2017112608,2017,12
ARI,27,JAX,24,3,1,2017112609,2017,12
OAK,21,DEN,14,7,1,2017112610,2017,12
PIT,31,GB,28,3,1,2017112611,2017,12
BAL,23,HOU,16,7,1,2017112700,2017,12
DAL,38,WAS,14,24,1,2017113000,2017,13
ATL,9,MIN,14,-5,0,2017120300,2017,13
BAL,44,DET,20,24,1,2017120301,2017,13
BUF,3,NE,23,-20,0,2017120302,2017,13
CHI,14,SF,15,-1,0,2017120303,2017,13
GB,26,TB,20,6,1,2017120304,2017,13
JAX,30,IND,10,20,1,2017120305,2017,13
MIA,35,DEN,9,26,1,2017120306,2017,13
NO,31,CAR,21,10,1,2017120307,2017,13
NYJ,38,KC,31,7,1,2017120308,2017,13
TEN,24,HOU,13,11,1,2017120309,2017,13
LAC,19,CLE,10,9,1,2017120310,2017,13
ARI,16,LA,32,-16,0,2017120311,2017,13
OAK,24,NYG,17,7,1,2017120312,2017,13
SEA,24,PHI,10,14,1,2017120313,2017,13
CIN,20,PIT,23,-3,0,2017120400,2017,13
ATL,20,NO,17,3,1,2017120700,2017,14
BUF,13,IND,7,6,1,2017121000,2017,14
CAR,31,MIN,24,7,1,2017121001,2017,14
CIN,7,CHI,33,-26,0,2017121002,2017,14
CLE,21,GB,27,-6,0,2017121003,2017,14
HOU,16,SF,26,-10,0,2017121004,2017,14
JAX,30,SEA,24,6,1,2017121005,2017,14
KC,26,OAK,15,11,1,2017121006,2017,14
TB,21,DET,24,-3,0,2017121007,2017,14
ARI,12,TEN,7,5,1,2017121008,2017,14
DEN,23,NYJ,0,23,1,2017121009,2017,14
LAC,30,WAS,13,17,1,2017121010,2017,14
LA,35,PHI,43,-8,0,2017121011,2017,14
NYG,10,DAL,30,-20,0,2017121012,2017,14
PIT,39,BAL,38,1,1,2017121013,2017,14
MIA,27,NE,20,7,1,2017121100,2017,14
IND,13,DEN,25,-12,0,2017121400,2017,15
DET,20,CHI,10,10,1,2017121600,2017,15
KC,30,LAC,13,17,1,2017121601,2017,15
JAX,45,HOU,7,38,1,2017121703,2017,15
CLE,10,BAL,27,-17,0,2017121702,2017,15
CAR,31,GB,24,7,1,2017121701,2017,15
BUF,24,MIA,16,8,1,2017121700,2017,15
MIN,34,CIN,7,27,1,2017121704,2017,15
NO,31,NYJ,19,12,1,2017121705,2017,15
NYG,29,PHI,34,-5,0,2017121706,2017,15
WAS,20,ARI,15,5,1,2017121707,2017,15
SEA,7,LA,42,-35,0,2017121708,2017,15
PIT,24,NE,27,-3,0,2017121709,2017,15
SF,25,TEN,23,2,1,2017121710,2017,15
OAK,17,DAL,20,-3,0,2017121711,2017,15
TB,21,ATL,24,-3,0,2017121800,2017,15
BAL,23,IND,16,7,1,2017122300,2017,16
GB,0,MIN,16,-16,0,2017122301,2017,16
CIN,26,DET,17,9,1,2017122402,2017,16
KC,29,MIA,13,16,1,2017122403,2017,16
NE,37,BUF,16,21,1,2017122404,2017,16
CHI,20,CLE,3,17,1,2017122401,2017,16
CAR,22,TB,19,3,1,2017122400,2017,16
NO,23,ATL,13,10,1,2017122405,2017,16
NYJ,7,LAC,14,-7,0,2017122406,2017,16
TEN,23,LA,27,-4,0,2017122407,2017,16
WAS,27,DEN,11,16,1,2017122408,2017,16
SF,44,JAX,33,11,1,2017122409,2017,16
DAL,12,SEA,21,-9,0,2017122411,2017,16
ARI,23,NYG,0,23,1,2017122410,2017,16
HOU,6,PIT,34,-28,0,2017122500,2017,16
PHI,19,OAK,10,9,1,2017122501,2017,16
ATL,22,CAR,10,12,1,2017123100,2017,17
DET,35,GB,11,24,1,2017123102,2017,17
IND,22,HOU,13,9,1,2017123103,2017,17
MIA,16,BUF,22,-6,0,2017123104,2017,17
MIN,23,CHI,10,13,1,2017123105,2017,17
NE,26,NYJ,6,20,1,2017123106,2017,17
NYG,18,WAS,10,8,1,2017123107,2017,17
PHI,0,DAL,6,-6,0,2017123108,2017,17
PIT,28,CLE,24,4,1,2017123109,2017,17
TB,31,NO,24,7,1,2017123110,2017,17
TEN,15,JAX,10,5,1,2017123111,2017,17
BAL,27,CIN,31,-4,0,2017123101,2017,17
SEA,24,ARI,26,-2,0,2017123115,2017,17
DEN,24,KC,27,-3,0,2017123112,2017,17
LAC,30,OAK,10,20,1,2017123113,2017,17
LA,13,SF,34,-21,0,2017123114,2017,17
